jammerlich-adj; adv	pathetic; miserably
 anschliefsend-adv;	subsequently;
inappropriately  armselig-adj; adv	pathetic; poorly
 irrelevant-adj	irrelevant
 einwandfrei-adj;	impeccable; flawlessly
 ungezogen-adj	rude
 verschlagen-adj;	devious; slyly; blend
 objectively; objective  erfrischend-adj	refreshing
 uberholt-adj	obsolete
 fehlend-adj	missing, absent
 homosexuell-adj;	homosexual;
 rau-adj; adv	rough; harshly
 bleich-adj	pale
 seekrank-adj	seasick
 machbar-adj	feasible
futsch-adj	gone (coll)
ehrenwert-adj; adv	honorable; honorably
mager-adj; adv	thin; thinly
unverzeihlich-adj;	unforgivable;
rasend-adj	frantic, furious
u nangebracht-adj;	inappropriate;
maximal-adj; adv	maximum; at most
lachend-adj; adv	laughing; laughingly
gescheit-adj	sensible
obdachlos-adj	homeless
vorbestraft-adj	previously convicted
unfreundlich-adj;	unfriendly
ungelegen-adj; adv	inconvenient; untimely
aberglaubisch-adj	superstitious
telefonisch-adv; adj	by phone; telephonic
ungeeignet-adj; adv	unsuitable; unsuitably
ungesund-adj; adv	unhealthy; unhealthily
verbittert-adj; adv	bitter; bitterly
antik-adj	antique, ancient
nervig-adj	annoying (coll)
gewillt-adj	willing
beunruhigend-adj;	troubling; worryingly
schlapp-adj; adv	limp; limply
schamlos-adj; adv	shameless;
irisch-adj	Irish
irdisch-adj	earthly
unglaubig-adj; adv	incredulous; doubtfully
unerreichbar-adj	unattainable
augenblicklich-adj;	current, instant;
ebenburtig-adj	equal
grotesk-adj; adv	grotesque; ludicrously
Vanille-F; adj	vanilla
unwurdig-adj; adv	unworthy; unworthily
vorzuglich-adj; adv	excellent; excellently
gnadenlos-adj; adv	merciless; mercilessly
kuhn-adj; adv	bold; audaciously
gleichma ig-adv;	evenly; consistent
uberglucklich-adj;	overjoyed, blissfully
unschlagbar-adj	invincible
koscher-adj	kosher
lebensmude-adj	suicidal
selbstsuchtig-adj;	selfish; selfishly
nobel-adj	posh
abwesend-adj	absent, distracted
strafba r-adj	punishable
aufd ri nglich-adj;	intrusive; intrusively
senii-adj	senile
uberlegt-adv; adj	informed, considered
dumpf-adj	dull
gestrig-adj	yesterday's
unmittelbar-adv;	directly; direct
impulsiv-adj; adv	impulsive; impulsively
brandneu-adj	brand new
sturmisch-adj; adv	stormy; thunderously
divers-adj	miscellaneous
fruchtbar-adj; adv	fertile; fruitfully
gutaussehend-adj	handsome
verlasslich-adj	reliable
haargenau-adj; adv	exact (coll); exactly
unzuverlassig-adj;	unreliable; unreliably
authentisch-adj	authentic
gefuhllos-adj; adv	callous; callously
stramm-adj	sturdy
durr-adj	scrawny, dry
intim-adj	intimate
schmeichelhaft-adj;	flattering; flatteringly
makellos-adj; adv	immaculate;
erhaben-adj; adv	lofty; loftily
uralt-adj	ancient
sparsam-adj; adv	economical;
unterirdisch-adj	underground
heikel-adj	delicate, tricky
unnaturlich-adj; adv	unnatural; unnaturally
legendar-adj	legendary
erniedrigend-adj	degrading
lieblich-adj	lovely
widerwa rtig-adj;	despicable;
knallhart-adj	tough (coll)
unbezahlbar-adj;	priceless; pricelessly
vorderer-adj	front, leading
inakzeptabel-adj	unacceptable
unterhaltsam-adj	entertaining
bizarr-adj	bizarre
unberuhrt-adj	pristine, untouched
glaubig-adj	religious
liebenswert-adj;	endearing; endearingly
aussichtslos-adj;	hopeless; hopelessly
uninteressant-adj	uninteresting
gelehrt-adj	erudite
u berdrussig-adj	weary
Genfer-adj	Genevan
schlafrig-adj; adv	sleepy; sleepily
aerbeste-adj	very best
unehrlich-adj; adv	dishonest; dishonestly
stehend-adj	standing, stationary
unreif-adj; adv	immature; immaturely
ledig-adj	single
ungeheuerlich-adj;	outrageous;
erfolglos-adj; adv	unsuccessful; without
grandios-adj	terrific
smart-adj	smart (coll)
kugelsicher-adj	bulletproof
unbrauchbar-adj	useless
rucksichtsvoll-adj;	considerate;
impotent-adj	impotent
spa Big-adj	funny
hamisch-adj	gloating
verschollen-adj	missing
parat-adj	ready, handy
selbstsicher-adj;	confident; confidently
frustrierend-adj	frustrating
murrisch-adj; adv	grumpy; grumpily
verschwitzt-adj	sweaty
verwundbar-adj;	vulnerable; vulnerably
allererster-adj	very first
unerwunscht-adj	undesirable
durchsichtig-adj;	transparent;
fuhrend-adj	leading
unerfahren-adj	inexperienced
sarkastisch-adj; adv	sarcastic; sarcasticaIly
leitend-adj	leading, conductive
u ngestraft-adj	unpunished
u nfruchtba r-adj	barren
schrill-adj	flashy, shrill
minderjahrig-adj	stunningly
kitschig-adj	corny
gell-adj	shrill, right (coll)
sundig-adj; adv	sinful; sinfully
allerletzter-adj	very last
feindselig-adj	hostile
schwungvoll-adj	bold, peppy
windig-adj	windy
wohlhabend-adj	wealthy
untrostlich-adj	heartbroken
glaubwurdig-adj	credible
demutig-adj; adv	humble; humbly
irrsinnig-adj; adv	insane; insanely
unzertrennlich-adj;	inseparable;
uberlaufen-vb; adj	overflow; overcrowded
kubanisch-adj	Cuban
hektisch-adj	hectic
kauflich-adj	problematically
Llberfallig-adj	overdue
schlafend-adj	asleep
landesweit-adv; adj	nationally; nationwide
hocherfreut-adj	delighted
wortwortlich-adv;	literally; literal
ekelig-adj	impeccably
unwissend-adj; adv	unaware; unwittingly
mafsig-adv; adj	moderately; moderate
kanadisch-adj	Canadian
anspruchsvoll-adj	demanding
bevorstehend-adj	imminent
morgiger-adj	tomorrow's
spektakular-adj	spectacular
leuchtend-adj	luminous
brenzlig-adj	dangerous (coll)
ausgeglichen-adj	balanced
wirr-adj	confused
kleinlich-adj	fussy
zerfallen-vb; adj	decompose;
emport-adj; adv	outraged; indignantly
wasserdicht-adj	waterproof
undicht-adj	leaking
verfuhrerisch-adj;	seductive; seductively
demutigend-adj	humiliating
beruchtigt-adj	notorious
ehrenvoll-adv; adj	honestly; honorable
urkomisch-adj; adv	hilarious; hilariously
furchterregend-adj;	terrifying; terrifyingly
zickig-adj	uptight (coll)
katastrophal-adj;	disastrous; disastrously
salzig-adj	salty
ungerade-adj	odd,uneven
wochentlich-adj;	weekly
kerngesund-adj	in perfect health
rassistisch-adj	racist
gottlos-adj	ungodly
versessen-adj	intent
sitzend-adj	sedentary
kraftvoll-adv; adj	powerfully; powerful
berechtigt-adj	entitled, eligible
ordinar-adj	vulgar, common
hellwach-adj	wide awake
vorstellbar-adj	conceivable
umfassend-adj	comprehensive
knusprig-adj	crispy
adlig-adj	noble
beschamend-adj;	shameful; shamefully
lateinisch-adj; N	Latin
metallisch-adj	metallic
brUnett-adj	brunette
unergrUndlich-adj;	unfathomable;
geistreich-adj	witty
verschlossen-adj	withdrawn, locked
verkommen-adj; vb;	depraved; go to waste;
eigensinnig-adj; adv	stubborn; stubbornly
vielerlei-adj	various
unbequem-adj; adv	uncomfortable;
gesprachig-adj	talkative
lebenswert-adj	worth living
entbehrlich-adj	expendable
zunehmend-adv;	increasingly; increasing
 offensiv-adj; adv	offensive;
 beieinander-adv	together
 obendrein-adv	moreover
 anschliefsend-adv; adj	subsequently;
impeccable;  verschlagen-adj; adv;	devious; slyly; blend
 insgeheim-adv	secretly
 homosexuell-adj; adv	homosexual;
 dermafsen-adv	so,such
ungultig-adj; adv	invalid; unlawfully
beleidigend-adj; adv	inhumanly offensive;
unangebracht-adj; adv	offensively inappropriate;
untereinander-adv	among themselves
ausnahmsweise-adv	exceptionally
rucksichtslos-adj; adv	reckless; recklessly
uberallhin-adv	abroad, everywhere
ununterbrochen-adv;	continuously;
zufaIligerweise-adv	accidentally
beisammen-adv	together
andersrum-adv	the other way
beunruhigend-adj; adv	troubling;
vorzUglich-adj; adv	excellent;
gegenwartig-adv; adj	currently; present
grolstenteils-adv	largely
allemal-adv	always
dummerweise-adv	unfortunately
unanstandig-adj; adv	indecent; indecently
bewundernswert-adj;	admirable;
aufdringlich-adj; adv	intrusive; intrusively
halbwegs-adv	halfway
nachhause-adv	home
glorreich-adj; adv	glorious; gloriously
empor-adv	upwards
sagenhaft-adj; adv	fabulous; fabulously
kopfUber-adv	head first
augenblicklich-adj; adv	current, instant;
genaugenommen-adv	strictly speaking
haufenweise-adv	tons of (coll)
rechtmaBig-adj; adv	legitimate; rightfully
rings-adv	around
ri.icksichtsvoll-adj; adv	considerate;
tags-adv	considerately
strahlend-adj; adv	radiant; brilliantly
sti.irmisch-adj; adv	stormy;
verwundbar-adj; adv	vulnerable;
panisch-adj; adv	panicked; in panic
zweifelsohne-adv	undoubtedly
eindrucksvoll-adj; adv	impressive;
atembera ubend-adj;	breathtaking;
nunmehr-adv	henceforth (fml);
demi.itig-adj; adv	humble; humbly
hoffnungsvoll-adj; adv	hopeful; hopefully
widerwartig-adj; adv	despicable;
hundertprozentig-adv	completely (coll);
auswarts-adv	outward, out
bestenfalls-adv	at best
zuallererst-adv	first of all
mi.irrisch-adj; adv	grumpy; grumpily
diesbezi.iglich-adv	in this respect
bergauf-adv	uphill
zwischendurch-adv	now and again
durchsichtig-adj; adv	transparent;
lachelnd-adj; adv	smiling; with a smile
rundherum-adv	around
gewandt-adj; adv	versatile; deftly
zuruckhaltend-adj; adv	reserved; with
phanomenal-adj; adv	phenomenal;
ubereinander-adv	pretentiously
unwiderstehlich-adj;	irresistible;
paarmal-adv	several times
notfalls-adv	if necessary
seltsamerweise-adv	strangely
ma Big-adv; adj	moderately;
gleichermaBen-adv	equally
woandershin-adv	elsewhere
unordentlich-adj; adv	messy; messily
freundlicherweise-adv	kindly
sonnig-adj; adv	sunny; sunnily
unbeschreiblich-adj;	indescribable;
inspirierend-adj; adv	inspiring
entzwei-adv	in half
unklug-adj; adv	unwise, unwisely
hilfsbereit-adj; adv	helpful; helpfully
folgendermaBen-adv	as follows
hinterhaltig-adj; adv	devious; deceptively
zunehmend-adv; adj	increasingly;
hieruber-adv	about this
kommerziell-adv; adj	commercially;
jeher-adv	*always
hierauf-adv	afterward, on this
anderweitig-adv	otherwise
viertens-adv	fourthly
beschamend-adj; adv	shameful;
soundso-adv	so and so
zuweilen-adv	sometimes (fml)
prachtvoll-adj; adv	gorgeous;
fortan-adv	from now on (fml)
belanglos-adj; adv	trivial;
scharfsinnig-adj; adv	perceptive;
vorsatzlich-adv; adj	intentionally;
Waschmaschine-F	washing machine
Logo-N/M; i	logo; duh (coll)
Limit-N	limit
Zusammenbruch-M	collapse
Makler-M	broker
Fahndung-F	search
Alarm bereitschaft-F	alert
Darm-M	intestine
Aufschrei-M	outcry
Nippel-M	nipple (coll)
Tyrann-M	tyrant, bully
Vormund-M	guardian
Gli::ickchen-N	(little) bell
Pelz-M	fur, coat
Marionette-F	impersonation
Bestechung-F	bribery
Regime-N	regime
Lachs-M	salmon
Schotte-M	Scot
Eintopf-M	stew
Gratulation-F	congratulations
Pointe-F	punchline
Bademantel-M	bathrobe
Paragraph-M	paragraph
Pickel-M	pimple
Einklang-M	unison
BUchse-F	can, rifle
Rektor-M	rector, principal
Alligator-M	demonstration
Barbier-M	barber (fml)
Stamm-M	stem, tribe
Lehrling-M	apprentice
Tanne-F	fir
Kran-M	crane
Belastigu ng-F	trouble, harassment
Kollektion-F	collection
Schlagzeug-N	drums
Horde-F	horde
Pi::ibel-M	mob, plebs (coll)
Patsche-F	trouble (coll)
Kamel-N	camel
Mauschen-N	sweetheart (coll)
Befugnis-F	warrant, authority
Farce-F	farce
Unterhalt-M	maintenance, alimony
Blutvergiefsen-N	bloodshed
BUrgersteig-M	sidewalk
Getriebe-N	transmission
Einzelhaft-F	solitary confinement
Schi-M	ski
Entschlossenheit-F	determination
Kopfgeld-N	bounty
Verurteilung-F	conviction
Prostitution-F	prostitution
Wohnheim-N	hostel, dorm
MolekUI-N	molecule
Serum-N	serum
Karussell-N	carousel
Erloser-M	savior
Eintrag-M	entry
Elch-M	moose
Kerker-M	dungeon
Arche-F	ark
MUcke-F	mosquito
Verwandlung-F	transformation
Durchfall-M	diarrhea
Knaller-M	firecracker (coll)
stottern-vb; N	stammer
Tresen-M	counter, bar
Landkarte-F	map
Begierde-F	desire
Denkmal-N	monument
Demo-N; F	demo (tape);
Blickwinkel-M	perspective
Vers-M	rhyme
Yoga-F	yoga
Ensemble-N	ensemble
Reklame-F	advertisement
Urteilsvermogen-N	judgment
Beil-N	hatchet
Ruin-M	perdition, undoing
Mast-M	mast, pole
Trauung-F	wedding (fml)
Treppenhaus-N	stairwell
Anfall-M	seizure, attack
Hochstapler-M	impostor
Wirtshaus-N	inn
Spatz-M	sparrow
Vorstellungskraft-F	imagination
Gruft-F	vault
lnternat-N	boarding school
Angsthase-M	coward (coll)
Abdruck-M	impression, imprint
Privilegium-N	privilege
Jackpot-M	jackpot
Migrane-F	migraine
Puzzle-N	puzzle
Schmerzmittel-N	painkiller
Drehort-M	(filming) location
Todesangst-F	fear of death
Schminke-F	makeup
GebUsch-N	brush, bushes
RUckstand-M	residue, *behind
Rekrut-M	recruit
Stander-M	pedestal
Fachmann-M	expert
Klammer-F	bracket, staple
Rohre-F	tube
Schimpanse-M	chimpanzee
Torpedo-M	torpedo
Unkraut-N	weed
Abwurf-M	drop
Hackfleisch-N	minced meat
Finanzierung-F	funding
Waggon-M	coach,car
Falke-M	falcon
Cello-N	cello
Automatik-F	automatic(s)
Favorit-M	favorite
Zauberstab-M	wand
Ausschnitt-M	extract, neckline
 Beihilfe-F	allowance, benefit
Schaffner-M	conductor (fml)
ZUgel-M	rein, control
Henker-M	executioner
Wahnvorstellung-F	delusion
Taille-F	waist
Polizeirevier-N	police station
Fass-N	barrel
Zimmermadchen-N	maid
Subjekt-N	subject
Buchhandlung-F	bookstore
Trophae-F	trophy
Kreuzfahrt-F	cruise
Abbild-N	image, likeness
TUrglocke-F	doorbell
GrofszUgigkeit-F	generosity, bounty
Kanalisation-F	sewer
GelUbde-N	vow
Karo-N	diamonds, check
Rasse-F	race, breed
Zweig-M	branch, twig
Kaktus-M	cactus
Vorstrafe-F	criminal record
Gemahl-M	spouse (fml)
Brenner-M	burner
Gliedmafse-F	limb
Demonstrant-M	protester
Stiel-M	stem
Einfall-M	idea, incidence
Atom-N	atom
Finanzamt-N	tax office
Gage-F	fee
Langweiler-M	geek (coll)
Jaguar-M	jaguar
Stinktier-N	skunk
Widerrede-F	backtalk
Todesfall-M	fatality, death
Begnadigung-F	pardon, amnesty
Schuster-M	cobbler
Zeitlang-F	*for a time
Lagerraum-M	storage room
Match-N/M	match
Aufschub-M	delay
Kerbe-F	notch
Funkspruch-M	radio message
Amnesie-F	amnesia
Anleitung-F	instructions
Redakteur-M	editor
Exekution-F	execution
Abrechnung-F	settlement, billing
Leuchtturm-M	lighthouse
Erschopfu ng-F	exhaustion
Spekulation-F	speculation
Hinterhof-M	backyard
Wiedergeburt-F	rebirth
Einzelganger-M	loner
Reue-F	remorse
WUrgen-vb; N	choke; retch
Klebeband-N	(duct) tape
Genesung-F	recovery
Biker-M	biker (coll)
Schwarm-M	swarm, crush
Bohrer-M	drill
Klon-M	clone
Brutalitat-F	brutality
Drucker-M	printer
Kronung-F	coronation
Orchidee-F	orchid
Schlitz-M	slot, slash
Marmor-M	marble
Detektiv-M	detective
Trauzeuge-M	best man
Tanzflache-F	dance floor
Prugelei-F	brawl
Flugbahn-F	trajectory
Logbuch-N	logbook
Engelchen-N	cherub
Bankuberfall-M	bank robbery
Schwertkampfer-M	swordsman
Lebensweise-F	way of life
Heuchelei-F	hypocrisy, pretense
Flugblatt-N	leaflet, broadsheet
Genugtuung-F	satisfaction
Hinterwaldler-M	hillbilly
Gluhbirne-F	(light) bulb
Damentoilette-F	ladies' (room)
Salbe-F	ointment
Kork-M	cork
Kante-F	edge
Ohrfeige-F	slap in the face
Epidemie-F	epidemic
Schokoriegel-M	chocolate bar
Bruchteil-M	fraction
Alphabet-N	alphabet
Regenmantel-M	raincoat
Zielperson-F	subject, target
Pramie-F	premium
Maskottchen-N	mascot
Wendung-F	turn, phrase
Sexualitat-F	sexuality
Ersatzteil-N	spare (part)
Junkie-M	junkie (coll)
Zugfuhrer-M	conductor, engineer
Fete-F	party (coll)
Manipulation-F	manipulation
Vorsitz-M	chairmanship
Jungling-M	youth (fml)
Swimmingpool-M	swimming pool
Staubsauger-M	vacuum cleaner
Bauchschmerz-M	stomachache
Morddezernat-N	homicide (squad)
Balkan-M	Balkans
Klopapier-N	toilet paper (coll)
Gutschein-M	voucher
Drogenhandel-M	drug dealing
Karneval-M	carnival
Intensivstation-F	ICU
Abteil-N	compartment
Delphin-M	dolphin
Lotterie-F	lottery
Flegel-M	boor (coll)
Laus-F	louse
Sage-F	saw
Mahl-N	meal
Spott-M	ridicule
GefaB-N	vessel, container
Kommode-F	dresser
Trance-F	trance
Mitgift-F	dowry
Demutigung-F	humiliation
Postbote-M	postman
Befriedigung-F	satisfaction
Vorahnung-F	premonition
Motivation-F	motivation
Mowe-F	seagull
Wohnsitz-M	residence
Fanatiker-M	zealot
Fusion-F	merger
Vorort-M	suburb
Duo-N	pair
Buchladen-M	bookstore
Erneuerung-F	renewal
FUller-M	pen
Beweismittel-N	evidence
Bahnsteig-M	platform
Simulation-F	simulation
Adaption-F	adaptation
Blockade-F	blockade
Kavalier-M	gentleman
Vagabund-M	vagabond
Reisende-M/F	traveler
Gelander-N	handrail
Schwatzer-M	big mouth (coll)
Umlauf-M	circulation
Gehaltserhohung-F	raise
Knopfchen-N	(little) button
Bauernhof-M	farm
Mythologie-F	mythology
Achterbahn-F	roller coaster
Abmarsch-M	start
SchieBpulver-N	gunpowder
Ohrring-M	earring
Puder-M	powder
DUnger-M	fertilizer
Verdienst-N; M	merit; earnings
Klumpen-M	lump
Markierung-F	marking
Erniedrigung-F	humiliation
Hebamme-F	midwife
Jahrmarkt-M	fair
Fegefeuer-N	purgatory
Knochenmark-N	(bone) marrow
Sarg-M	coffin
Fehlfunktion-F	malfunction
Sabbat-M	Sabbath
Marathon-M	marathon
Geldstrafe-F	fine
Reflex-M	reflex
Tramp-M	tramp
Zimmermann-M	carpenter
Vermachtnis-N	legacy
Pein-F	torment (fml)
Verzug-M	default, delay
Ozean-M	ocean
Mayonnaise-F	mayonnaise
Gasthaus-N	inn
Pantoffel-M	slipper
Rassist-M	racist
ManikUre-F	manicure
Plankton-N	plankton
Kreuzer-M	cruiser
Laufbahn-F	career, track
Harte-F	hardness
SchIussfolgerung-F	conclusion
Blasphemie-F	blasphemy
Mix-M	mix
Schriftrolle-F	scroll
Wappen-N	crest, emblem
lnjektion-F	injection
Schauplatz-M	scene
Plasma-N	plasma
Taugenichts-M	good for nothing
Scherbe-F	shard
Kittel-M	tunic, gown
Faulnis-F	decay
Katholik-M	Catholic
Zensur-F	censorship
Kapitalismus-M	capitalism
Schraubenzieher-M	screwdriver
Mundgeruch-M	bad breath
Foul-N	foul
Filmmaterial-N	footage
Krampf-M	cramp
Kassette-F	cassette, cartridge
Balg-M/N	brat (coll)
Kolumbien-N	Colombia
einschreiben-vb; N	register; registered
Freiraum-M	freedom, open space
Artefakt-N	artifact
Traktor-M	tractor
Gesundheitsamt-N	board of health
Stich-M	sting, stitch
Miene-F	countenance, face
Punsch-M	punch
ldol-N	idol
Kabinett-N	cabinet
Zugabe-F	bonus, addition
Abstammung-F	descent
Korsett-N	corset
Ausstrahlung-F	charisma, broadcast
Rindfleisch-N	beef
Vorgehensweise-F	method, approach
Tausender-M	grand (coll)
Tollwut-F	rabies
Schlachter-M	butcher
Erfrischung-F	refreshment
Apostel-M	apostle
Apfelkuchen-M	apple pie
Fundament-N	foundation
Geleit-N	escort
Behauptung-F	assertion, claim
Filiale-F	branch (office)
Verpflegung-F	catering, food
Vorkehrung-F	precaution
Rasiermesser-M	razor
Geheimhaltung-F	secrecy
lmbiss-M	snack, diner
Umkleideraum-M	locker room
Raumschiff-N	spaceship
Kies-M	gravel
Sekte-F	cult
Stichwort-N	keyword, cue
Posaune-F	trombone
Knuppel-M	club
Instruktion-F	instruction
Spitzel-M	snitch (coll)
Kraut-N	herb,cabbage
Karawane-F	caravan
Delle-F	dent
Klischee-N	stereotype
Anziehungskraft-F	appeal
Curry-M/N	curry
Schwarzmarkt-M	black market
Abbruch-M	termination
Erschaffung-F	creation (fml)
Skalpell-N	scalpel
Toilettenpapier-N	toilet paper
Anrufer-M	caller
Bezeichnung-F	label
Kelch-M	goblet
Vorliebe-F	preference
Narkose-F	anesthesia
Eroberung-F	conquest
Kurzschluss-M	short (circuit)
Gefolge-N	entourage
Faulpelz-M	slacker
Gurke-F	cucumber
Turnhalle-F	gym
Rivale-M	rival
Steinbruch-M	quarry
Kapuze-F	hood
Falschgeld-N	counterfeit money
Knacker-M	geezer (coll)
Kanne-F	pot
Gelaber-N	shit (coll)
Pyramide-F	pyramid
Spielplatz-M	playground
Plakat-N	poster
Gemetzel-N	slaughter
Wucht-F	force
Hausherr-M	host, landlord
Fluchtweg-M	escape route
Kuken-N	baby bird
Buffet-N	buffet
Vorabend-M	evening before
Enkelkind-N	grandchild
Haftstrafe-F	prison sentence
Aufschlag-M	surcharge, impact
Protein-N	protein
Beruhigung-F	reassurance, calming
Kraftwerk-N	power plant
Splitter-M	splinter
Courage-F	courage
Schnuffler-M	snooper
Joghurt-M/N/F	yoghurt
Moderator-M	presenter
Dichtung-F	seal, poetry
Tranengas-N	tear gas
Stereoanlage-F	stereo
Milz-F	spleen
Comic-MIN	comic
Sperrgebiet-N	restricted zone
Wachposten-M	guard
Adoption-F	adoption
Sims-M/N	ledge
Moos-N	moss, money (coll)
Urne-F	urn
Sabel-M	saber
Peilung-F	bearing
Chemiker-M	chemist
Sirup-M	syrup
FuBabdruck-M	footprint
Opium-N	opium
rascheln-vb; N	rustle; swish
Talisman-M	talisman
Zement-M	cement
Seelenklempner-M	shrink (coll)
Gleichheit-F	equality
Reservat-N	reservation
Anstellung-F	employment
Pot-N	pot (coll)
Abteilungsleiter-M	department manager
Schub-M	thrust, boost
Unterbewusstsein-N	subconscious
Lehrbuch-N	textbook
Verwandtschaft-F	relationship, relatives
Fiktion-F	fiction
Kupplung-F	clutch
Lawine-F	avalanche
Eifer-M	zeal
BuBe-F	penance
TOrsteher-M	bouncer, doorman
berlegung-F	consideration
Ekstase-F	frenzy
Saat-F	seed
Zahnstocher-M	toothpick
Arsenal-N	arsenal
Gefahrte-M	companion
Showgeschaft-N	showbiz (coll)
Kreuzzug-M	crusade
Versohnung-F	reconciliation
Revanche-F	revenge (fml)
Vorrang-M	priority
Rekord-M	record
Funke-M	spark
Kolben-M	piston
Mixer-M	blender
Bewachung-F	guard
Badeanzug-M	swimsuit
Mitmensch-M	fellow man
Copyright-N	copyright
Chrom-N	chrome
Mudigkeit-F	fatigue
Sternschnuppe-F	shooting star
Durchsuchung-F	search
Vergnugungspark-M	theme park
Sporthalle-F	sports hall
Refrain-M	chorus
Flammenwerfer-M	flame thrower
Parole-F	password, slogan
Mond-M	moon
Witzfigu r-F	laughingstock
Christentum-N	Christianity
Autopilot-M	autopilot
Schutzengraben-M	trench
Hummel-F	bumblebee
Apotheker-M	pharmacist
Komplott-N	conspiracy
Krieger-M	warrior
Transfer-M	transfer
Most-M	cider
Fiasko-N	fiasco
Bosnien-N	Bosnia
Eroberer-M	conqueror
FuBspur-F	footprint
Totenkopf-M	skull
Patriotismus-M	patriotism
Gespott-N	mockery
Kranz-M	wreath
Feindseligkeit-F	hostility
Einzug-M	collection, entry
Statthalter-M	governor
Popo-M	butt (coll)
Volt-N	volt
Suchtrupp-M	search party
Unterfangen-N; vb	undertaking, venture
Juwelier-M	jeweler
Weber-M	weaver
Portrait-N	portrait
Abzweigung-F	junction, branch
Oberfluss-M	abundance
Schluckchen-N	little drink
Rettungsboot-N	lifeboat
Schauspielerei-F	acting
Requisit-N	prop
Krucke-F	crutch
Hering-M	herring
Formalitat-F	formality
Redensart-F	idiom, saying
Attrappe-F	dummy
Jockey-M	jockey
Ventilator-M	fan
Gewissensbiss-M	remorse
Bewunderer-M	admirer
Arrangement-N	arrangement
Spinat-M	spinach
erloschen-vb; N	expire; expiration
Depot-N	depot, deposit
Operationssaal-M	surgery
Erzahlung-F	narrative
Blindganger-M	dud, nonstarter
Annaherung-F	approach,
Schusslinie-F	line of fire
Jubilaum-N	anniversary
Blech-N	sheet (metal)
Gespur-N	intuition, sense
Aufpasser-M	chaperone
Patriot-M	patriot
Gestein-N	rock
Prasidium-N	headquarters
Wunderkind-N	prodigy
Magd-F	maid
Vergaser-M	carburetor
Schaufenster-N	show window
Uhrwerk-N	clockwork
Petroleum-N	kerosene
Denkweise-F	mindset
Burde-F	burden, liability
Jacht-F	yacht
Dossier-NIM	dossier
Waffel-F	waffle
Sprengung-F	detonation
Klapsmuhle-F	nuthouse (coll)
Dienstmarke-F	badge
Gram-M	grief (fml)
Geback-N	cookies
Flaschchen-N	vial
lntrige-F	intrigue
Zuckerwatte-F	cotton candy
Schurze-F	apron
 Mathematiker-M	mathematician
Zauberspruch-M	(magic) spell
Partikel-F	particle
Vergessenheit-F	oblivion
Schutzschild-N	shield
Nobelpreis-M	Nobel prize
 Meineid-M	perjury
 Telefonat-N	phone call
 Kleiderschrank-M	wardrobe
 Oberschenkel-M	thigh
 Anta rktis-F	Antarctic
Kohlendioxid-N	carbon dioxide
Ballast-M	ballast
Luftschleuse-F	airlock
Abschuss-M	launch
Erektion-F	erection
Milliardar-M	billionaire
Lokomotive-F	locomotive
Raubtier-N	predator
Sonnenbrand-M	sunburn
Deal-M	deal (coll)
Brut-F	spawn
Perversion-F	perversion
Wiederbelebu ng-F	revival, resuscitation
Alge-F	alga
Hygiene-F	hygiene
Kot-M	manure
Gequatsche-N	chatter (coll)
Fanfare-F	fanfare
Biographie-F	biography
Frustration-F	frustration
Webseite-F	website
Pforte-F	gate
Exempel-N	example (fml)
Meute-F	mob
Medizinmann-M	shaman
Zeugena ussage-F	testimony
Tiefpunkt-M	low
Plunder-M	rubbish
Verfolgungsjagd-F	chase
StraBenrand-M	roadside
Plananderung-F	change of plan
Set-N/M	set
Streuner-M	stray
Orgel-F	organ
Affchen-N	little monkey
Ration-F	ration
Menschenseele-F	(human) soul
Geldborse-F	purse
Schnappchen-N	bargain
Unterredung-F	discussion
ldentifikation-F	identification
Lautstarke-F	volume, loudness
StrauB-M	bunch, ostrich
Widmung-F	dedication
Deserteur-M	deserter
Besteck-N	cutlery
Abneigung-F	dislike
Trommelwirbel-M	drum roll
Zufluchtsort-M	sanctuary
Romantiker-M	romantic
Macke-F	quirk (coll)
Faschismus-M	fascism
Betaubungsmittel-N	sedative
Foyer-N	lobby
Lava-F	lava
Schlafsack-M	sleeping bag
Schauer-M	awe, shower
Vorzug-M	preference,
Spionage-F	espionage
Barriere-F	barrier
PfUtze-F	puddle
BUrste-F	brush
Kapsel-F	capsule
Paddel-N	paddle
Blickfeld-N	focus
Schwert-N	sword
Slogan-M	slogan
Stabilitat-F	stability
Gedarm-N	bowels
Schlagzeuger-M	drummer
Kruste-F	crust
Modus-M	mode
Kollision-F	collision
Navigator-M	navigator
Totung-F	killing
Verzeichnis-N	directory
Serbien-N	Serbia
Nachstenliebe-F	charity
SchuhgroBe-F	shoe size
Tschechoslowa kei-F	Czechoslovakia
Dirne-F	prostitute
Erbe-N; M	heritage; heir
Streber-M	nerd (coll)
 Bit-N	bit
 Rockstar-M	rock star (coll)
 Bitterkeit-F	bitterness
 Aussprache-F	pronunciation, debate
Lokfuhrer-M	engineer
Faser-F	fiber
Pate-M	godfather
Leichenbeschauer-M	coroner
Phase-F	phase
Huf-M	hoof
Lateinamerika-N	Latin America
Tapete-F	wallpaper
Festplatte-F	hard drive
Telefonist-M	operator
Petition-F	petition
Strophe-F	verse, stanza
Konfrontation-F	confrontation
Herausgeber-M	publisher
Hardware-F	hardware
Steuermann-M	helmsman
Spurensicherung-F	forensics
Kupfer-N	copper
Plutonium-N	plutonium
Socke-F	sock
Kluft-F	gap, outfit (coll)
Eisschrank-M	refrigerator
Bildhauer-M	sculptor
Ernennung-F	appointment,
Verbandszeug-N	bandages
Pokal-M	trophy (cup)
Hinterteil-N	rear, butt (coll)
Navigation-F	navigation
Ausbeutung-F	exploitation
Orakel-N	oracle
Slum-M	slum
Verwechslung-F	confusion, mistake
Hehler-M	fence
Riesending-N	big deal (coll)
Tagung-F	meeting, conference
Kleinkind-N	baby
Maschinerie-F	machinery
Appell-M	appeal
Armbanduhr-F	wristwatch
Kittchen-N	clink (coll)
Henne-F	hen
Verfolger-M	pursuer
Verhangnis-N	fate
Kost-F	fare, diet
Gaul-M	horse (coll)
Ehrenmedaille-F	medal of honor
Roulette-F	roulette
Pose-F	pose
Hosentasche-F	pocket
Arterie-F	artery
Karat-N	carat
Trumpf-M	trump
Rudel-N	pack
Fluglinie-F	airline
Schwertkampf-M	swordfight
Horoskop-N	horoscope
Stickstoff-M	nitrogen
Gebiss-N	set of teeth
Schema-N	scheme
Bewusstsei n-N	awareness
Rasierer-M	razor (coll)
Koje-F	bunk
Zusammenfassung-F	abstract
Geschoss-N	floor, projectile
Partisan-M	partisan
Bubi-M	little boy (coll)
Schwadron-F	squadron
Mappe-F	folder
Schlupfer-M	briefs, panties
Wendepunkt-F	turning point
Motte-F	moth
Dialog-M	dialogue
Amnestie-F	amnesty
Pilz-M	mushroom, fungus
Gladiator-M	gladiator
Ziffer-F	digit
Abschlussfeier-F	graduation
Transvestit-M	transvestite
Lagune-F	lagoon
Zepter-N/M	scepter
Skifahren-N	skiing
Verdauung-F	digestion
Kokosnuss-F	coconut
Transaktion-F	transaction
Ultimatum-N	ultimatum
Rehabilitation-F	rehabilitation
Bistro-N	bistro
Kettenreaktion-F	chain reaction
Sozialhilfe-F	welfare
Stabchen-N	chopstick
Vorsatz-M	resolution
Oberfall-M	attack
Misserfolg-M	failure
Jahrbuch-N	yearbook
Schwalbe-F	swallow
Codename-M	codename
Segler-M	sailor
Rollbahn-F	tarmac
Tang-M	seaweed
Kulisse-F	backdrop
Tentakel-M/N	tentacle
Karpfen-M	carp
Jalousie-F	shutter, (sun) blind
Krumel-M	crumb
Besinnung-F	reflection
Werbespot-M	commercial
Knechtschaft-F	servitude
Zahlmeister-M	paymaster
Verdammnis-F	damnation
Oberweisung-F	transfer
StraBenbahn-F	tram
Kleber-M	glue, gluten
Seemann-M	sailor
Spezialgebiet-N	specialty
Kenner-M	connoisseur
Probeaufnahme-F	test shot
Brustkorb-M	ribcage
Diplomat-M	diplomat
Bagger-M	excavator
Patenonkel-M	godfather
lndio-M	Indian
Lahmung-F	paralysis
Globus-M	globe
Wildschwein-N	boar
Meteorit-M	meteorite
Puck-M	puck
Gluhwurmchen-N	firefly
Heiligkeit-F	holiness
Kauderwelsch-N	gibberish
gemach-adv; N	slowly; chamber (fml)
Zyklop-M	Cyclops
Aroma-N	aroma, flavor
Meeting-N	meeting
Segelboot-N	sailboat
Untergeschoss-N	basement
Verleihung-F	award
Schwellung-F	swelling
Wollust-F	lust
Delirium-N	delirium
Verleumdung-F	slander
Hohn-M	scorn, mockery
Weihwasser-N	holy water
Verdeck-N	(folding) top
Bandenkrieg-M	gang war
Kinderheim-N	orphanage
Akkordeon-N	accordion
Sondereinheit-F	task force
Zusammensein-N	gathering; being together
Schallplatte-F	record
Ablosung-F	replacement
Pelzmantel-M	fur coat
Melancholie-F	melancholy
Nullpunkt-M	zero point
Macker-M	bloke (coll)
Klaps-M	smack (coll)
Guru-M	guru
Borsenmakler-M	stockbroker
Brautkleid-N	wedding dress
Beisein-N	presence
Einhalt-M	stop, brake
Heuschrecke-F	locust
Heiligtum-N	sanctuary
lndiz-N	clue
Brosche-F	brooch
Funker-M	radio operator
Wettrennen-N	race
Rummel-M	hype
Oberzahl-F	majority
Giraffe-F	giraffe
Flop-M	flop (coll)
Triade-F	triad
Lebzeit-F	lifetime
Likor-M	liquor
Scheckbuch-N	checkbook
Zusammenstofs-M	collision
BO rokratie-F	bureaucracy
Bankraub-M	bank robbery
Wimper-F	eyelash
Deckname-M	alias
lntensitat-F	intensity
Interpretation-F	interpretation
Spritzer-M	splash
Erpresser-M	blackmailer
Ruhestorung-F	disturbance
Morgenmantel-M	dressing gown
Kap-N	cape
Leichtigkeit-F	lightness, ease
Etikette-F	etiquette
Lack-M	paint, lacquer
Bombardierung-F	bombing
Schar-F	flock
Fullung-F	filling
Lockvogel-M	decoy
Badehose-F	bathing suit
Einlage-F	insert, deposit
Pfahl-M	stake
Beinbruch-M	broken leg
Postfach-N	mailbox
Umwandlung-F	conversion,
Verpackung-F	packaging
Nationalitat-F	nationality
Zeppelin-M	airship
Rittmeister-M	(cavalry) captain
Todestag-M	date of death
Werfer-F	pitcher
Eiswurfel-M	ice cube
Schachzug-M	gambit
lmmunitat-F	immunity
MOsli-N	cereals
Drecksloch-N	hellhole (coll)
Variante-F	variant
Transpla ntation-F	transplant
Vorkommnis-N	occurrence, incident
Meisterstuck-N	masterpiece
Diagramm-N	chart
Detonation-F	detonation
Fahrwerk-N	chassis
abfinden-vb; vbr	pay off; accept
durchqueren-vb	cross
erleuchten-vb	light (up)
enthullen-vb	reveal
verkraften-vb	cope with
austricksen-vb	fool (coll)
verschlagen-adj; adv;	devious; slyly; blend
verpacken-vb	wrap, pack
irritieren-vb	irritate
hetzen-vb	rush
abschlachten-vb	slaughter
buchstabieren-vb	spell
verklemmen-vb	jam
besturzen-vb	upset
kreuzigen-vb	crucify
teilhaben-vb	participate, share
verhauen-vb	spank (coll)
gro ziehen-vb	raise
bestreiten-vb	deny
spendieren-vb	buy (coll)
hineingehen-vb	goin
durchdenken-vb	think through
versohnen-vb	reconcile
abbrennen-vb	burn (down)
(he)rumstehen-vb	stand around
ausrusten-vb	equip
krepieren-vb	die (coll)
absitzen-vb	serve time (coll)
abriegeln-vb	lock down
versperren-vb	bar
schmoren-vb	stew
zusammenbrechen-vb	collapse
einjagen-vb	*scare
hochkommen-vb	come up
hergeben-vb	give (away)
sausen-vb	speed (coll); swish
rasten-vb	rest
ergehen-vb; vbr	fare; gush
erniedrigen-vb	humiliate
verstummen-vb	silence
behindern-vb	hinder
ausgraben-vb	dig up
abdrehen-vb	turn
klammern-vb	cling
ertappen-vb	catch
wiedererkennen-vb	recognize
beschimpfen-vb	insult
pladieren-vb	plead
abschlagen-vb	refuse
abfangen-vb	intercept
vergewissern-vb	make sure
traben-vb	trot
zelten-vb	camp
ausschneiden-vb	cut (out)
besichtigen-vb	visit
grollen-vb	resent, rumble
autorisieren-vb	authorize
Oberreichen-vb	hand over
verspielen-vb	gamble away, lose
offenbaren-vb	reveal
ermutigen-vb	encourage
pennen-vb	sleep (coll)
widerfahren-vb	happen (fml)
zerlegen-vb	disassemble
beistehen-vb	assist
abwischen-vb	wipe (off)
bewohnen-vb	inhabit
absperren-vb	seal off
hasten-vb	scurry, race
notigen-vb	compel
WOrgen-vb; N	choke; retch
schminken-vb	make up
zuruckbekommen-vb	get back
entschlusseln-vb	decipher
verschwimmen-vb	blur
blenden-vb	glare, blind, disguise
altern-vb	age
missachten-vb	disregard
zertrummern-vb	smash
zerschmettern-vb	smash
Obertreffen-vb; vbr	exceed; excel
rammen-vb	ram
entbehren-vb	spare, lack
konstruieren-vb	construct
verstandigen-vb; vbr	notify, communicate
auffressen-vb	eat up (coll)
beheben-vb	correct
verkrampfen-vb	cramp
heften-vb	baste
entscha rfen-vb	defuse
standhalten-vb	withstand
trollen-vb	troll (coll)
verschreiben-vb; vbr	prescribe; be
fallenlassen-vb	drop
beibehalten-vb	maintain
kidnappen-vb	kidnap
kaputtmachen-vb	break
beklauen-vb	steal from
niesen-vb	sneeze
lauern-vb	lurk
verschenken-vb	give away
ertranken-vb	drown
u ntersagen-vb	forbid
meckern-vb	complain (coll)
spotten-vb	scoff, mock
kneifen-vb	pinch
zubereiten-vb	prepare
spuken-vb	haunt
vollmachen-vb	fill (up)
zufugen-vb	cause, inflict
besteigen-vb	board, climb
aufladen-vb	charge, load
umhauen-vb	blow one's mind
krampfen-vb	seize
verbluten-vb	bleed out
vorsingen-vb	audition, sing to
behuten-vb	protect
weiterziehen-vb	move on
verwusten-vb	devastate
auffliegen-vb	fly up, get busted
bruhen-vb	brew
aufheitern-vb	cheer (up)
blamieren-vb	disgrace
anheben-vb	raise
zusammenreilsen-vbr	control oneself
abkuhlen-vb	cool
bowlen-vb	bowl
reimen-vb	rhyme
joggen-vb	jog
schwanzen-vb	cut, skip (coll)
verschicken-vb	send (out)
aufmuntern-vb	cheer up
falschen-vb	fake
ausbrennen-vb	burn out
recherchieren-vb	research
renovieren-vb	renovate
taufen-vb	baptize
uberarbeiten-vb; vbr	revise, overdo things
spezialisieren-vb	specialize
wegziehen-vb	pull (away), move
absteigen-vb	descend
aufrufen-vb	call, invoke
flattern-vb; N	flutter; wobble
ackern-vb	plow, work hard
pensionieren-vb	retire
hammern-vb	pound
erneuern-vb	renew
abliefern-vb	deliver
miauen-vb	meow
durchfallen-vb	fail
versinken-vb	sink
spalten-vb	split
ablosen-vb	detach, replace
uberweisen-vb	transfer
eintauschen-vb	trade
erkunden-vb	explore, find out
verhelfen-vb	help to
verkorpern-vb	embody, represent
verkuppeln-vb	set up
anschreien-vb	shout at
verbeugen-vbr	bow
zusammenziehen-vb	contract, move in
bemitleiden-vb	pity
hinbekommen-vb	get
aufwuhlen-vb	churn, stir up
hypnotisieren-vb	hypnotize
aufsitzen-vb	mount (up)
verseuchen-vb	contaminate
einspringen-vb	fill in
erlassen-vb	waive, issue
Libergehen-vb	ignore, overflow
luften-vb	ventilate, reveal
erlernen-vb	learn
vermobeln-vb	beat up (coll)
klimpern-vb	tinkle
untertauchen-vb	disappear
mixen-vb	mix
wickeln-vb	wind, wrap
wackeln-vb	wiggle
spruhen-vb	spray
zerstuckeln-vb	dismember
ausschlafen-vb	sleep in
misshandeln-vb	abuse
rumpeln-vb	rumble
flippen-vb	flip (out)
wandeln-vb	convert, walk
rummachen-vb	make out (coll)
bestehlen-vb	steal from
stabilisieren-vb	stabilize
lasten-vb; nnpl	weigh; charges
vorrucken-vb	advance
entehren-vb	dishonor
verschleppen-vb	delay, abduct
verbluffen-vb	amaze
uberblicken-vb	overlook
uberlisten-vb	outsmart
nachweisen-vb	prove
hintergehen-vb	cheat
plundern-vb	plunder
anfertigen-vb	make, manufacture
kapitulieren-vb	surrender
durchstehen-vb	get through
nachladen-vb	recharge
bezwingen-vb	defeat
nachvollziehen-vb	comprehend, track
(he)rumliegen-vb	lie around
motivieren-vb	motivate
ausstrecken-vb	stretch
Uberlasten-vb	overload
erlegen-vb	kill
belagern-vb	besiege
hinhalten-vb	stall
einreden-vb	persuade
verstUmmeln-vb	mutilate
besaufen-vbr	get wasted (coll)
aufdecken-vb	uncover
hineinziehen-vb	implicate, involve
abfUhren-vb	lead away
abstreiten-vb	deny
absichern-vb	secure
beschmutzen-vb	stain
kultivieren-vb	cultivate
wiederherstellen-vb	restore
schimpfen-vb	rant, offend
Uberfluten-vb	flood, overrun
praktizieren-vb	practice
niederbrennen-vb	burn (down)
aufgreifen-vb	capture, address
verheilen-vb	heal
schmieden-vb	forge
vertagen-vb	postpone
hinschicken-vb	send
spionieren-vb	spy
austragen-vb; vbr	deliver; unsubscribe
erwUnscht-vb	desirable
abhacken-vb	chop (off)
handhaben-vb	handle
trUben-vb	cloud, tarnish
ablassen-vb	drain
Uberfordern-vb	overwhelm
verwanzen-vb	bug
schleudern-vb	hurl, spin
absuchen-vb	search
gliedern-vb	divide, structure
vorlegen-vb	submit
aufdrehen-vb	loosen
wiedergeben-vb	reproduce, play
runterholen-vb	bring down,
langen-vb	reach, be enough
zerstreuen-vb	disperse
belehren-vb	teach
heimbringen-vb	bring home
fluten-vb	flood
angstigen-vb	frighten
aufkreuzen-vb	show up (coll)
UberfUhren-vb	transport
beschworen-vb	invoke
durchlaufen-vb	go through
nominieren-vb	nominate
komponieren-vb	compose
vorgeben-vb	pretend
aufschneiden-vb	slice
abschreiben-vb	copy; write off
drangeln-vb	scramble, push
abspielen-vb	play (back)
einweisen-vb	instruct
totlachen-vb	die laughing
zerren-vb; vbr	drag; strain
Ubersteigen-vb	exceed
verka beln-vb	wire
einlosen-vb	redeem, cash
masturbieren-vb	masturbate
unterziehen-vb; vbr	fold in; submit to
vererben-vb	inherit
zuruckverfolgen-vb	retrace
auspeitschen-vb	whip
begnadigen-vb	pardon
abspringen-vb	jump (off)
beehren-vb	honor (fml)
nachwachsen-vb	grow back
auskennen-vbr	be well informed
bescheren-vb	bring, grant
uberschwemmen-vb	flood
tolerieren-vb	tolerate
bugeln-vb	iron
schlupfen-vb	slip, hatch
bewiigen-vb	grant, approve
anketten-vb	chain
muhen-vbr	struggle, strive
salutieren-vb	salute
versohlen-vb	spank
distanzieren-vbr	dissociate
festnageln-vb	pin (down)
kraftigen-vb	strengthen
schrubben-vb	scrub (coll)
tarnen-vb	disguise
aushelfen-vb	help (out)
walten-vb	prevail (fml)
deportieren-vb	deport
uberfullen-vb	overcrowd
einwenden-vb	object
funkeln-vb	sparkle
inspizieren-vb	inspect
zugucken-vb	watch (coll)
durchdringen-vb	penetrate
erdulden-vb	endure
durchbohren-vb	pierce
signieren-vb	sign
verdammen-vb	condemn, damn
koordinieren-vb	coordinate
hingeben-vbr; vb	indulge in; hand over
freisprechen-vb	absolve
(he)runterlasse n-vb	lower, let down
verbocken-vb	mess up (coll)
zuruckschlagen-vb	fight back
verabreichen-vb	administer
beflecken-vb	stain
dammern-vb	dawn
farben-vb	dye
reintun-vb	put in (coll)
abkaufen-vb	buy
knistern-vb	crackle
vermachen-vb	leave to
herbitten-vb	ask to come
verubeln-vb	resent
herrichten-vb	arrange
aufbleiben-vb	stay up
auszahlen-vb	pay off
u nterkriegen-vb	get down
zugehen-vb	shut (coll), reach
schnitzen-vb	carve
umstimmen-vb	sway
amputieren-vb	amputate
sabotieren-vb	sabotage
vertun-vb	waste
erzwingen-vb	force
anzapfen-vb	tap
aussperren-vb	lock out
fegen-vb	sweep
revanchieren-vbr	return the favor
verzehren-vb	consume
anbauen-vb	grow
erwahlen-vb	choose (fml)
beanspruchen-vb	claim
abschicken-vb	send
abwaschen-vb	wash off, do the
Oberlaufen-vb; adj	overflow;
aufbrauchen-vb	deplete
austrinken-vb	finish (drinking)
zusammentun-vbr; vb	get together;
verspannen-vb	brace
abtrennen-vb	detach
verblassen-vb	fade
abservieren-vb	ditch (coll)
grubeln-vb	brood
inhaftieren-vb	imprison
vorhersagen-vb	predict, forecast
verspotten-vb	mock
erringen-vb	gain, win
steppen-vb	tap (dance), stitch
preisgeben-vb	reveal
fauchen-vb; N	hiss
einfadeln-vb; vbr	thread; merge
kreieren-vb	create (fml)
dabeihaben-vb	carry (coll), have on
voraussagen-vb	predict
quetschen-vb	squeeze
fasten-vb	fast
rulpsen-vb; N	burp (coll); burping
nachmachen-vb	imitate
verfaulen-vb	rot
ausrotten-vb	exterminate
herausbekommen-vb	find out
experimentieren-vb	experiment
schummeln-vb	cheat
wurfeln-vb	roll (dice)
wegschaffen-vb	get rid of
einschenken-vb	pour
weglassen-vb	omit
bursten-vb	brush
kombinieren-vb	combine
verlangsamen-vb	slow (down)
zuweisen-vb	assign
faxen-vb	fax
wiedergutmachen-vb	make up for
sprayen-vb	spray
mahen-vb	mow
anbei en-vb	bite
dampfen-vb	dampen, steam
einchecken-vb	check in
rubergehen-vb	go over to (coll)
gutgehen-vb	work out
schrumpfen-vb	shrink
nachholen-vb	make up, catch up
anstiften-vb	incite
abwehren-vb	fend off
ausrufen-vb	exclaim, declare
tatowieren-vb	tattoo
hereinspazieren-vb	walk in
schwanken-vb	vary, fluctuate
stampfen-vb	stomp
pellen-vb	peel (coll)
anbelangen-vb	concern
schwinden-vb	wane
bandigen-vb	tame
losziehen-vb	head out
erstarren-vb	freeze
rohren-vb	roar
abkratzen-vb	scrape (off)
zieren-vb; vbr	decorate; hesitate
verduften-vb	beat it (coll)
picken-vb	peck, pick
verschmelzen-vb	merge
vorschreiben-vb	prescribe, stipulate
zermalmen-vb	crush
ermuden-vb	tire
schOtten-vb	pour, throw
hochheben-vb	lift
freimachen-vb; vbr	clear; undress
verscheuchen-vb	scare away
einstufe n-vb	classify
austeilen-vb	distribute
Oberbrucken-vb	bridge
eskortieren-vb	escort
tradeIn-vb	dawdle (coll), linger
beschneiden-vb	cut
einbuchten-vb	lock up (coll)
verschlechtern-vb	deteriorate
eingestehen-vb	admit
einlochen-vb	hole, put behind bars
herunterkommen-vb	come down,
verhangen-vb	impose, declare
umschreiben-vb	rewrite
verspeisen-vb	eat (fml)
anbeten-vb	worship
beleuchten-vb	illuminate
versteinern-vb	petrify
entlarven-vb	expose
ausschwa rm en-vb	swarm
bereinigen-vb	settle
hochnehmen-vb	bust (coll)
streuen-vb	scatter
wahren-vb	last (fml)
verstauchen-vb	sprain
abbeiBen-vb	bite (off)
anpacken-vb	tackle, handle
tratschen-vb	gossip (coll)
klirren-vb	clink
entfachen-vb	ignite
hissen-vb	hoist
festsitzen-vb	be stuck
veralten-vb	become outdated
verzoge rn-vb	delay
ausreiBen-vb	run away (coll)
erblicken-vb	see, behold
weggeben-vb	remove (AT); give
anflehen-vb	beg
besiegeln-vb	seal
verfangen-vbr	get caught
durchlassen-vb	let through, transmit
entbinden-vb	release
bekleiden-vb	dress
ertraumen-vbr	picture
freisetzen-vb	release
durchschlagen-vb; vbr	smash; fend for
frisieren-vb	fudge (coll)
zusammenpassen-vb	fit together
entsorgen-vb	dispose of
losmachen-vb; vbr	release; groove
assistieren-vb	assist
verrichten-vb	achieve, perform
abschutteln-vb	shake (off)
abraumen-vb	clear
zerschneiden-vb	cut
unterlassen-vb; N	refrain from; failure
stricken-vb	knit
dehnen-vb	stretch
applaudieren-vb	applaud
genesen-vb	recuperate
spekulieren-vb	speculate
widerrufen-vb	revoke
bekmmern-vb	worry
verwischen-vb	blur
verkriechen-vbr	hide
anbinden-vb	tie
prophezeien-vb	predict
Obertreten-vb	violate, cross
schiefgehen-vb	go wrong
exekutieren-vb	execute
weiterlaufen-vb	continue
konkurrieren-vb	compete
reinschauen-vb	stop by (coll)
schmucken-vb	decorate
zusammenbringen-vb	collect, get together
labern-vb	babble (coll)
n iederlassen-vb; vbr	lower; settle
meIken-vb	milk
verspuren-vb	feel
enthaupten-vb	behead
geleiten-vb	escort
einrosten-vb	rust
postieren-vb	post
kodern-vb	lure
kandidieren-vb	run for a post
einteilen-vb	divide up, split up
rekrutieren-vb	recruit
schopfen-vb	draw
nachlassen-vb	ease
entziffern-vb	decipher
wegpusten-vb	blow away (coll)
quaken-vb	quack
entschadigen-vb	compensate
nahren-vb	nourish, feed
stapeln-vb	pile (up)
verschlimmern-vb	worsen
demolieren-vb	demolish
anschaffen-vb	purchase
ausraumen-vb	clear
schanden-vb	defile
knabbern-vb	nibble
gluhen-vb	glow
ausarbeiten-vb	elaborate, draw up
horten-vb	hoard
zappeln-vb	fidget
verpfuschen-vb	mess up (coll)
durchkammen-vb	comb
Oberkommen-vb	overcome
kribbeln-vb; N	tingle
kopfen-vb	behead
vernaschen-vb	eat up (coll)
ausbringen-vb	apply, *propose
Aal-M	eel
abbezahlen-vb	pay off
abblasen-vb	call off (coll)
abbringen-vb	dissuade
abstatten-vb	pay
abstechen-vb	stab
Abstecher-M	detour, trip
abstoßen-vb	repel, eject
abtauchen-vb	disappear
abtreiben-vb	have an abortion
abtrocknen-vb	dry
abtrünnig-adj	rogue
Abweichung-F	deviation
abfackeln-vb	torch
abweisend-adj;	dismissive; dismissively
abfallen-vb	fall off, decrease
Abführmittel-N	laxative
abgelegen-adj	remote, isolated
abwimmeln-vb	put off (coll)
abgewöhnen-vb	break loose of, give up
ableben-vb; N	die (fml); demise (fml)
Administration-F	administration
ablesen-vb	read
Admiralität-F	Admiralty
abmurksen-vb	kill (coll)
abnutzen-vb	wear out
Affentheater-N	charade
abrasieren-vb	shave off
abraten-vb	advise against
abrechnen-vb	invoice, settle
Aktivierung-F	activation
Abreibung-vb	beating (coll)
alarmieren-vb	alert
abrücken-vb	move away
abrupt-adj; adv	abrupt; abruptly
Allee-F	avenue, alley
absägen-vb	saw off
Alleinsein-N	loneliness
absaugen-vb; N	exhaust; exhausting
alleinstehend-adj	single, isolated
abschaffen-vb	abolish, remove
allergrößte-adj	utmost, greatest
abschieben-vb	deport
allerwichtigste-adj	most important
Abschlag-M	deduction, discount
Allgemeinheit-F	general public
allzeit-adv	always
alsbald-adv	immediately
Abschrift-F	transcript
absorbieren-vb	absorb
Absperrung-F	barrier
Absprache-F	arrangement
absprechen-vb	deny, arrange
Altenheim-N	nursing home
official; officially Amulett-N	amulet
Analytiker-M	analyst
Anarchist-M	anarchist
Anbeginn-M	inception (fml)
anbrennen-vb	burn
Anbruch-M	dawn
andauern-vb	last
andocken-vb	dock
andrehen-vb	turn on
anfällig-adj	prone, vulnerable
anfeuern-vb; N	root for; rooting for
anfreunden-vbr	become friends
Anstandsdame-F	chaperone
anstößig-adj; adv	offensive; offensively
Anstoß-M	impetus
anstreben-vb	strive for, seek for
Ansturm-M	rush
antreffen-vb	find, meet
Anus-M	anus
anvisieren-vb	target, plan
Anwaltskanzlei-F	law firm
anzetteln-vb	instigate (coll)
Apartment-N	apartment
Apfelsaft-M	apple juice, cider
appellieren-vb	appeal
Archäologe-M	archaeologist
Areal-N	area
Argentinier-M	Argentinean
Ärgernis-N	nuisance
Arier-M	Aryan
Armaturenbrett-N	dashboard
Armenhaus-N	poorhouse
Asphalt-M	asphalt
anzweifeln-vb	doubt
angehören-vb	associate, belong
Angelrute-F	fishing rod
angewidert-adj;	disgusted; in disgust
Ankläger-M	prosecutor, accuser
anlächeln-vb	smile at
anlassen-vb; N	start; tempering
anlaufen-vb	accumulate, start
anlocken-vb	attract
anmutig-adj; adv	graceful; gracefully
annähen-vb	sew on
annehmbar-adj;	reasonable; reasonably
atomar-adj	nuclear
attackieren-vb	attack
Attest-N	certificate
aufblasen-vb	inflate
auferlegen-vb	impose, inflict
Auffahrt-F	driveway
auffangen-vb	catch, absorb
Aufforderung-F	request, invitation
auffrischen-vb	refresh
auffüllen-vb	fill (up), replenish
aufgabeln-vb; N	pick up (coll); picking up
Aufgebot-N	posse
Aufbruch-M	departure, tear
Anomalie-F	anomaly
Anprobe-F	fitting
anreden-vb	address
anreisen-vb	arrive
Ansammlung-F	collection
ansatzweise-adv	to some extent
Anschreiben-N; vb	cover letter; score
Anschrift-F	address
Anspielung-F	allusion
anspringen-vb	start
anschleichen-vbr;	sneak up; sneaking up
Aufkleber-F	sticker, label
auflesen-vb	pick up
Aufmachung-F	layout
Aufmunterung-F	encouragement
Auspuff-M	exhaust (pipe)
ausquetschen-vb	squeeze (out)
ausradieren-vb	erase
ausreiten-vb	ride out
  Aufrührer-M	rebel
ausbeuten-vb	exploit
ausbezahlen-vb	pay off
Autoradio-N	car radio
ausblasen-vb	blow out
Autoreifen-M	car tire
ausbluten-vb	bleed out
Autorennen-N	racing
ausborgen-vb	borrow (AT)
Ausbruch-M	outbreak
auschecken-vb; N	check out
ausdrucken-vb	print (out)
auserkoren-adj	predestined (fml)
Ausfall-M	failure, loss
banal-adj	banal
Bandage-F	bandage
ausfragen-vb	interrogate
Bankdirektor-M	bank director
ausfressen-vb	erode, eat up (coll)
Banknote-F	banknote
ausgestoßen-adj	outcast
Bankwesen-N	banking (industry)
barbarisch-adj;	barbaric; barbarically
Ausgrabung-F	excavation
  aufsagen-vb	recite
aufsammeln-vb	pick up
aufschließen-vb	unlock, develop
Aufschrift-F	inscription, label
aufspielen-vb	play, install
aufspießen-vb	impale
Aufstand-M	riot
auftanken-vb	refuel
auftauen-vb	thaw
aufwischen-vb	clean up
aufzählen-vb	enumerate
Augapfel-M	eyeball
Auktionator-M	auctioneer
ausbaden-vb	pay for (coll)
  Ausguck-M	lookout
Ausrottung-F	eradication
aussätzig-adj; adv	leprous; leprously
ausschlagen-vb	refuse
ausspielen-vb	display, play
ausspionieren-vb	spy on
ausspucken-vb	spit (out)
ausstechen-vb	poke out, excel
Australier-M	Australian
austreiben-vb	expel, exorcise
austreten-vb	escape, resign
austrocknen-vb; N	dry out; draining
auswechseln-vb	replace, change
Bardame-F	barmaid
Baseballspiel-N	baseball game
Basislager-N	base camp
baumeln-vb	dangle
basteln-vb	tinker, make
Aushilfe-F	auxiliary, temp
auskosten-vb	savor
ausladen-vb	unload
Auslieferung-F	delivery, extradition
Baustein-M	building block
Beatmung-F	ventilation
beaufsichtigen-vb	supervise
Belegschaft-F	staff
bemannen-vb	man
bemerkbar-adj	noticeable, perceptible
benebeln-vb	mist, befuddle
berauschen-vb	intoxicate
berechenbar-adj	predictable
bereichern-vb	enrich
bereisen-vb	visit, travel
bereitstehen-vb	be ready, stand by
bemalen-vb	paint
Beduine-M	Bedouin
bedürftig-adj; adv	needy; needily
befehligen-vb	command
Befehlsgewalt-F	authority
befriedigend-adj	satisfactory
Begebenheit-F	occurrence
begeben-vb; vbr	issue; resort, proceed
Bergung-F	recovery, salvage
Bergwerk-N	mine
begierig-adj; adv	eager; eagerly
beglücken-vb	please
besagt-adj	aforementioned
besänftigen-vb	placate
Beschaffenheit-F	nature, composition
begutachten-vb	survey, examine
Bescherung-F	mess (coll)
behaart-adj	hairy
beharren-vb; N	insist; insistence
beschmieren-vb	smear
beherbergen-vb	host, accommodate
beige-adj	beige
Beschuss-M	bombardment
Beinarbeit-F	footwork
beiwohnen-vb	attend (fml)
bekanntlich-adv	as you know
Beschwörung-F	incantation
Beseitigung-F	disposal
besinnen-vbr	reflect
Besitzurkunde-F	deed
bekehren-vb	convert
Besorgung-F	errand
bekifft-adj	stoned (coll)
bekriegen-vb	war
belauschen-vb	overhear, eavesdrop
Bestattung-F	funeral
Bestrahlung-F	irridation
bestreben-vb; N	endeavor
Bestseller-M	bestseller
bestücken-vb	equip, arm
besudeln-vb	sully
betätigen-vb	operate, press
Betäubung-F	anesthesia
betören-vb	infatuate (fml)
bloßstellen-vb	expose
blubbern-vb	bubble (coll)
Bohne-F	bean
Bombardement-N	bombing
boshaft-adj	vicious
Boutique-F	boutique
boykottieren-vb	boycott
brandmarken-vb	denounce
Brandstifter-M	arsonist
Brandung-F	surf
brauchbar-adj	suitable
Brauch-M	custom
Bräune-F	tan
Brautpaar-N	newlyweds
Brennholz-N	firewood
Brennstoff-M	fuel
Briefkasten-M	mailbox
brodeln-vb	bubble
Broschüre-F	brochure
Bruchlandung-F	crash landing
Brunch-M	brunch
bücken-vb	bend over
buddeln-vb	dig (coll)
Bügel-M	shackle
Busch-M	bush
Bußgeld-N	fine
Cabaret-N	cabaret (AT)
Campingplatz-M	campsite
chic-adj; adv	chic
Chloroform-N	chloroform
Cholesterin-N	cholesterol
Chorgesang-M	choral singing
chronisch-adj; adv	chronic; chronically
Clique-F	gang
Comeback-N	comeback
betrauen-vb	entrust
Betrug-M	fraud
Bettlaken-N	(bed) sheet
Bettwäsche-F	bedding
Beunruhigung-F	concern, worry
beurlauben-vb	take a leave of absence
bewähren-vb	prove oneself
Bewässerung-F	irrigation
bewegend-adj;	touching; movingly
bezichtigen-vb	accuse
Bienenstock-M	hive
bildlich-adj; adv	figurative; figuratively
Billion-F; nu	trillion
bisweilen-adv	sometimes (fml)
Blazer-M	blazer
blinken-vb	flash, blink
blinzeln-vb	blink
dirigieren-vb	conduct
Dissertation-F	dissertation
Dampfer-M	steamer
Dämpfer-M	cushion, damper
Diva-F	diva
Doktorarbeit-F	doctoral thesis
Doktortitel-M	doctorate
Däne-M	Dane
dänisch-adj; N	Danish
Darsteller-M	actor
datieren-vb	date
dazugehören-vb	belong
donnernd-adj; adv	thunderous;
Dozent-M	lecturer
Drachen-M	kite
drankriegen-vb	nail (coll)
Deckmantel-M	cloak, guise
Deck-N	deck
degradieren-vb	degrade
draufsetzen-vb	sit on it (coll)
draufstehen-vb	be written on, say
Drehbuch-N	script
Drogenbehörde-F	drug enforcement
dekorieren-vb	decorate
Delegation-F	delegation
Drogerie-F	drugstore
drosseln-vb	throttle, slow down
drumherum-adv	around
durchgeben-vb	enforcement
durchgeknallt-adj	nuts (coll)
durchkreuzen-vb	thwart, cross
durchleben-vb	undergo
durchlöchern-vb	perforate
durchnässen-vb	soak
dichtmachen-vb	shut down (coll)
Diebesgut-N	stolen goods
Diener-M	servant
dienstlich-adj; adv	official; officially
Diktator-M	dictator
diktieren-vb	dictate
dinieren-vb	dine (fml)
Diplomatie-F	diplomacy
Denkzettel-M	punishment, lesson
Drüse-F	gland
Derby-N	derby
duellieren-vbr	duel
derweil-adv	meanwhile
Duett-N	duet
duften-vb	smell
desertieren-vb	desert
Dunst-M	haze, mist
Duplikat-N	duplicate
diagnostizieren-vb	diagnose
durchbringen-vb	see through
Diakon-M	deacon
durchfahren-vb	pass through
Dialyse-F	dialysis
Durchführung-F	implementation,
Einöde-F	wasteland
einordnen-vb	classify
einplanen-vb	schedule
einreiben-vb	rub (in)
einsacken-vb	sack, pocket (coll)
einsammeln-vb	collect
einschleusen-vb	plant
einschnappen-vb	snap
einschreiten-vb	intervene
einstudieren-vb	rehearse
einstürzen-vb	collapse
Einsturz-M	collapse
einstweilig-adj;	temporary; temporarily
einweihen-vb	inaugurate, christen
Einweisung-F	instruction
einwerfen-vb	interject, throw in
einwickeln-vb	wrap
einwilligen-vb	comply, approve
Einwohner-M	inhabitant
einzahlen-vb	deposit
eisig-adj; adv	icy; icily
Elektrik-F	electricity
Elfe-F	elf
Empfangsdame-F	receptionist
empörend-adj	outrageous
energisch-adj; adv	energetic; vigorously
entern-vb	board
durchstellen-vb	put through
durchtrennen-vb	sever
Düse-F	nozzle
duzen-vb	address informally
Eber-M	boar
Edelstein-M	gem
ehelichen-vb	marry (fml)
ehemals-adv	formerly, previously
ehrbar-adj; adv	honorable; respectably
ehrwürdig-adj	dignified
eigens-adv	specially, specifically
einäschern-vb	cremate
Einberufung-F	convocation, convening
einbrennen-vb; N	brand; baking
einbuchen-vb	register
Einfachheit-F	simplicity
einfahren-vb	retract, arrive
einfallsreich-adj;	imaginative;
einfältig-adj; adv	resourcefully
Einfaltspinsel-M	simpleton
einfliegen-vb	approach, fly in
einflussreich-adj	influential
einfügen-vb	insert
Eingabe-F	input, feed
eingraben-vb	bury
eingrenzen-vb	contain, limit
einkreisen-vb	circle
einlaufen-vb	shrink, arrive
einleben-vbr	settle
Einlieferung-F	referral, admission
entfesseln-vb	unleash
entflammen-vb	inflame
erhellen-vb	lighten (up)
erkaufen-vb	buy
erkenntlich-adj	grateful, recognizable
entheben-vb	relieve
erklimmen-vb	scale (fml)
Enthüllung-F	revelation
erklingen-vb	(re)sound, ring out
entlasten-vb	relieve, release
Entlein-N	duckling
erliegen-vb	succumb
entmutigen-vb	discourage
erörtern-vb	discuss
entreißen-vb	wrest
entrinnen-vb	escape (fml)
entsenden-vb	send
erröten-vb	blush
entsichern-vb; N	unlock; unlocking
erschallen-vb	resound (fml)
entspannend-adj	relaxing
entspringen-vb	spring from, originate
erstbeste-adj	(very) first
enttarnen-vb	expose
erstehen-vb	purchase, arise
enttäuschend-adj	disappointing
entwaffnen-vb	disarm
ersuchen-vb; N	request
Entzündung-F	inflammation
Epilepsie-F	epilepsy
erwägen-vb	consider
erahnen-vb	imagine
Erwähnung-F	mention, reference
erwärmen-vb	warm (up)
erwirken-vb	obtain
erzürnen-vb	anger
erbeuten-vb	obtain, capture
erblinden-vb	go blind
erblühen-vb	bloom
erdenklich-adj;	imaginable; imaginably
Erdöl-N	(crude) oil
erdrosseln-vb	strangle
erdrücken-vb	overwhelm, crush
erfrischen-vb	refresh
ergo-adv	ergo
ergründen-vb	fathom
Erhalt-M	receipt, preservation
etabliert-adj	established
Etikett-N	label
Etui-N	case
existierend-adj	existing
Exkursion-F	excursion
expandieren-vb	expand
Expansion-F	expansion
Export-M	export
exquisit-adj; adv	exquisite; exquisitely
fabrizieren-vb	manufacture
Fahrschein-M	ticket
Fallschirmjäger-M	paratrooper
Falltür-F	trapdoor
Familienleben-N	home life
farbenblind-adj	colorblind
Fasan-M	pheasant
fassungslos-adj;	stunned; in disbelief
Faszination-F	fascination
Faulheit-F	laziness
Fechter-M	fencer
Fehde-F	feud
fehlerhaft-adj;	faulty; incorrectly
Fehltritt-M	lapse, misstep
Feierlichkeit-F	solemnity, ceremony
Feindschaft-F	hostility
Fell-N	fur
Ferienlager-N	summer camp
fertigen-vb	manufacture
fertigstellen-vb	finish
Fertigstellung-F	completion
festbinden-vb	tie
festfahren-vb	get stuck
festigen-vb	consolidate
Festival-N	festival
festmachen-vb	fasten, attach
Festmahl-N	feast
fettig-adj	greasy
feuerbereit-adj	ready to fire
feurig-adj; adv	fiery; ardently
Fiedler-M	fiddler
Filmgeschäft-N	film industry
Filou-M	rogue (coll)
Filzlaus-F	crab (louse)
Filz-M	felt
Fingerspitze-F	fingertip
Fitnessstudio-N	gym
Fleischfresser-M	carnivore
flennen-vb	cry (coll)
flink-adj; adv	swift; nimbly
Flirt-M	flirt
Flohmarkt-M	flea market
Fluch-M	curse
Flugfeld-N	airfield (AT)
Flussufer-N	riverbank
Flutwelle-F	tidal wave
Föhn-M	hairdryer
Fokus-M	focus
formell-adv; adj	formally; formal
Formsache-F	technicality
fortwährend-adj;	perpetual; perpetually
fossil-adj; N	fossil
Fotoapparat-N	camera
Frachtraum-M	cargo hold
Fragebogen-M	questionnaire
Fragerei-F	questions (coll)
fraglich-adj; adv	questionable; in
Fratze-F	question
Frauenarzt-M	gynecologist
freikaufen-vb	buy freedom
freudig-adj; adv	happy; joyfully
frigide-adj	frigid
Friseuse-F	hairdresser (coll)
Fruchtblase-F	water, amniotic sac
Frust-M	frustration (coll)
Fügung-F	providence
fungieren-vb	act as
Funkgerät-N	radio
funktionsfähig-adj	functional
gefühlvoll-adj; adv	emotional; emotionally
gegeben-adj	given, factual
Gegengift-N	antidote
Gegenseitigkeit-F	reciprocity
Funkverbindung-F	radio connection
fürsorglich-adj	caring
fürwahr-adv	indeed (fml)
Fusel-M	booze (coll)
Geheimgang-M	secret passage
gackern-vb	cackle
gähnen-vb; N	yawn
galant-adj; adv	gallant; gallantly
Gänseblümchen-N	daisy
geheuer-adj	safe, comfortable
Geheul-N	bawling
gehoben-adj	upper, sophisticated
Gasthof-M	inn
Gebärmutter-F	uterus
Gebell-N	barking
Geber-M	donor
Gehweg-M	sidewalk
Geiselnahme-F	hostage taking
geistesgestört-adj	deranged
Geizkragen-M	miser (coll)
gekühlt-adj	chilled
geladen-adj	angry (coll), loaded
Geldmenge-F	money supply
Geldwäsche-F	money laundering
Gebräu-N	concoction
Gemeinheit-F	dirty trick
Gemütlichkeit-F	coziness
Gemüt-N	disposition, mind
genehm-adj	convenient (fml)
Generalprobe-F	dress rehearsal
gedeihen-vb	thrive
Gedränge-N	crowd
gedulden-vbr	be patient
Gefährdung-F	threat
Gefangennahme-F	capture
Genialität-F	genius
Geologie-F	geology
Gepäckträger-M	luggage carrier
Gefängnisstrafe-F	prison sentence
Gefechtsstand-M	command post
Gefrierschrank-M	freezer
gefügig-adj; adv	compliant; compliantly
geraum-adj	considerable
geräumig-adj; adv	spacious; spaciously
Gerinnsel-N	clot
Gerüst-N	framework, scaffolding
Geschicklichkeit-F	skill
Geschwader-N	squadron
Geschwafel-N	gibberish (coll)
geschwind-adj;	quick; quickly (coll)
gesellig-adj	sociable
Gesichtszug-M	feature
Gesinnung-F	attitude
Gespann-N	team
Geständnis-N	confession
gestreift-adj	striped
Gesuch-N	request, petition
gewahrt-adj	maintained, respected
gewissenhaft-adj;	diligent; diligently
gewünscht-adj	required, desired
Ghetto-N	ghetto
glasklar-adj	crystal clear
glaubhaft-adj; adv	credible; credibly
glitschig-adj	slippery
glitzern-vb; N	sparkle
Glückseligkeit-F	bliss
Glückstreffer-M	lucky shot
glühend-adj; adv	glowing; glowingly
Gönner-M	patron
Göttlichkeit-F	divinity
Grauen-N; vb	horror; dawn
Gravitation-F	gravity
greifbar-adj; adv	tangible; tangibly
grell-adj; adv	harsh; glaringly
grenzenlos-adj;	unlimited; infinitely
grimmig-adj; adv	grim; grimly
großmütig-adj;	generous; generously
Grübchen-N	dimple
grundgütig-adj	gracious
Grünzeug-N	greens (coll)
gruppieren-vb	cluster
Gurgel-F	throat
gurgeln-vb	gargle
gurren-vb	coo
Guthaben-N	credit
gutheißen-vb	endorse, ratify
guttun-vb	do good
Gynäkologe-M	gynecologist
haften-vb; N	adhere; adherence
halbieren-vb	cut in half
Handfläche-F	palm
Hängematte-F	hammock
Hanswurst-M	buffoon
Häufchen-N	handful
Hauptgewinn-M	jackpot
häuslich-adj; adv	domesticated;
Hausnummer-F	domestically
Heer-N	army
Heide-M; F	pagan; heather
heidnisch-adj	pagan
Heiland-M	savior
heilend-adj; adv	healing; medicinally
heimsuchen-vb	haunt
heimtückisch-adj	treacherous
heimzahlen-vb	get back at (coll)
heiser-adj; adv	husky; huskily
Hemisphäre-F	hemisphere
herablassend-adj;	condescending;
herausputzen-vb	dress up
herausreißen-vb	tear out
herbestellen-vb	call in
herfallen-vb	attack
hergerissen-adj	conflicted
herkriegen-vb	get (coll)
hernehmen-vb	get
Herrenhaus-N	mansion
herrschend-adj	ruling, dominant
herumführen-vb	conduct, show around
herumliegen-vb	lie around
Herzfrequenz-F	heart rate
hierlassen-vb	leave
Hilfsmittel-N	means, aid
hinauswerfen-vb	throw out
hinauszögern-vb	stall
Hinblick-M	regard
hinhauen-vb	work (coll)
hinken-vb; N	limp
hinknien-vbr	kneel down
hinschauen-vb	look
hinschmeißen-vb	quit (coll)
hinterlegen-vb	deposit, lodge
hintun-vb	put (coll)
Hochachtung-F	appreciation
hochhalten-vb	uphold
hochklettern-vb	climb up
hochmütig-adj;	haughty; haughtily
infiltrieren-vb	infiltrate
infolge-adv; prp	as a result; owing to
Infusion-F	infusion
Inhaber-M	owner
inhalieren-vb; N	inhale; inhalation
injizieren-vb	inject
Innenseite-F	interior
innig-adj; adv	intimate; dearly
Inserat-N	ad
inständig-adv; adj	urgently; imploring
Intimität-F	intimacy
Inventar-N	inventory
Inventur-F	inventory
Joch-N	yoke
jonglieren-vb; N	juggle; juggling
Judentum-N	Judaism
Jurist-M	lawyer
Kabeljau-M	cod
Kaffeepause-F	coffee break
Kajüte-F	cabin
holprig-adj; adv	rough; roughly
Holzkopf-M	bonehead (coll)
Holzschnitt-M	woodcut
Hommage-F	homage
horchen-vb	listen (fml)
huckepack-adv; M	piggyback
Hufschmied-M	blacksmith
Hühnerstall-M	henhouse
huldigen-vb	worship
Hülse-F	sheath
Hundegebell-N	dog barking
Hungersnot-F	famine
Hungerstreik-M	hunger strike
hurtig-adj; adv	swift; swiftly
Hustensaft-F	cough syrup
Hyäne-F	hyena
Hydraulik-F	hydraulics
Hymne-F	anthem
hypothetisch-adj; adv	hypothetical; hypothetically
Idealist-M	idealist
Ideologie-F	ideology
ignorant-adj; M	ignorant (coll)
Ignoranz-F	ignorance
Immunität-F	immunity
impfen-vb	vaccinate
Impfstoff-M	vaccine
implantieren-vb	implant
imponieren-vb	impress
inbegriffen-adj;	included; including
Kalbfleisch-N	veal
knipsen-vb	snap (coll)
kaltmachen-vb	kill (coll)
knirschen-vb; N	crunch; grinding
Kalzium-N	calcium
Knopfdruck-M	push of a button
kampfbereit-adj	ready to fight
kampflos-adv; adj	without a fight
Kanarienvogel-M	canary
Kochtopf-M	saucepan
Kanonenkugel-F	cannonball
Kollaps-M	collapse
Kapazität-F	capacity, expert
kollektiv-adj; adv	collective; collectively
kapern-vb	capture
Kolonne-N	convoy
Kapitän-M	captain
kaputtgehen-vb	break down
Kassierer-M	cashier, clerk
Kaste-F	caste
kastrieren-vb	castrate
Komplexität-F	complexity
Katakombe-F	catacomb
Kegel-M	cone
Keil-M	wedge
Keim-M	germ, seed
Kennwort-N	password
Kettensäge-F	chainsaw
keusch-adj; adv	chaste; chastely
Keuschheit-F	chastity
kinderleicht-adj	very easy
Kinderschänder-M	child molester
Kiosk-M	kiosk
Kondensator-M	capacitor
Konditorei-F	confectionery
Konföderation-F	confederacy
konföderiert-adj	confederate
konform-vb	compliant
Konkurs-M	bankruptcy
Konstellation-F	constellation
Konsument-M	consumer
Kirmes-F	fair
klamm-adj; F	clammy; ravine
klatschnass-adj	soaking wet (coll)
Klausur-F	exam
klebrig-adj; adv	sticky; stickily
Klebstoff-M	glue
Kleinholz-N	firewood
Kloster-N	monastery
Klotz-M	block, chunk
Klugheit-F	wisdom
knackig-adj	crisp
Knast-M	slammer
Kniescheibe-F	kneecap
Kontext-M	context
Kontostand-M	account balance
Kontrolleur-M	inspector
kontrovers-adj;	controversial;
konvertieren-vb	controversially
Koordination-F	coordination
Kopfverletzung-F	head injury
Korkenzieher-M	corkscrew
Körperbau-M	build
Kosmetikerin-F	cosmetician
kostspielig-adj	costly
Kostüm-N	costume
krabbeln-vb	crawl
krankhaft-adj; adv	morbid; morbidly
kraus-adj	curly
Krawall-M	ruckus
Krempel-M	stuff (coll)
leger-adj; adv	casual; casually
legitim-adj; adv	legitimate; legitimately
lehrreich-adj	educational
Leichenwagen-M	hearse
Kreuzfeuer-N	crossfire
Kreuzigung-F	crucifixion
Leitartikel-M	editorial
Lektüre-F	read(ing)
Leopard-M	leopard
Kriegsschiff-N	warship
Lerche-F	lark
Kripo-F	crime squad
Leuchtfeuer-N	beacon
Krippe-F	crib
Lichtjahr-N	light year
Liebchen-N	sweetheart (fml)
krönen-vb	crown, top
Liebesnest-N	love nest (coll)
krümmen-vb	bend, squirm
liebkosen-vb	caress
Kruzifix-N	crucifix
kühlen-vb	chill
liieren-vb	hook up
Kühlraum-M	freezer
Lilie-F	lily
Kult-M	cult
liquidieren-vb	unwind, liquidate
lockern-vb	loosen, relax
Kundgebung-F	rally, demonstration
Lorbeer-M	laurel, bay
losschicken-vb	send (out)
Kurator-M	curator
Lotion-F	lotion
kurieren-vb	cure
Lotus-M	lotus
kursieren-vb	circulate
Luftröhre-F	windpipe
Kurzform-F	short form
Luftschacht-M	air shaft
kuscheln-vb	cuddle
Kutte-F	habit
lachhaft-adj; adv	ludicrous; ludicrously
Laichzeit-F	spawning season
Larve-F	larva
Läuterung-F	catharsis
Lavendel-N; adj	lavender
lynchen-vb; N	lynch; lynching
Maat-M	mate
Mädchenname-M	maiden name
Magenschmerz-M	stomach pain
Magister-M	Master's degree
Magnetfeld-N	magnetic field
leblos-adj; adv	lifeless; lifelessly
Makrele-F	mackerel
Manifest-N	manifesto
manövrieren-vb	maneuver
Markenzeichen-N	trademark
mitsingen-vb	sing along
Mitspieler-M	teammate
mittelalterlich-adj	medieval
Mittelamerika-N	Central America
mittelmäßig-adj	mediocre
maskieren-vb	mask
massenhaft-adv;	plenty of; plentiful
massenweise-adv	tons of
Master-M	master
Möchtegern-M	wannabe (coll)
Modenschau-F	fashion show
Modul-N/M	module
Masturbation-F	masturbation
Möhre-F	carrot
Mätresse-F	mistress
matsch-adj; M	exhausted (coll); mud
meditieren-vb	meditate
Monolog-M	monologue
montieren-vb	mount, install
Meeresspiegel-M	sea level
Melder-M	messenger, detector
Morgenrock-M	robe
Mentalität-F	mentality
Merkur-M	Mercury
Metier-N	profession
Metzgerei-F	butcher's (shop)
Müllabfuhr-F	refuse collection
Mietvertrag-M	lease
Müllhalde-F	(garbage) dump
mimen-vb	mime
multipel-adj	multiple (fml)
minder-adv; adj	less; inferior
Mündung-F	mouth, muzzle
missfallen-vb; adj	displease; displeased
Münztelefon-N	pay phone
Murmeltier-N	groundhog
miterleben-vb	witness, see
mitgeben-vb	give
mithelfen-vb	help
mithören-vb	listen
Mysterium-N	mystery
nichtig-adj	void
mystisch-adj; adv	mystical; mystically
Nabel-M	navel
nachahmen-vb	imitate
niederknien-vb	kneel down
niederschießen-vb	shoot
niederträchtig-adj	vile
Nachfahre-M	descendant
nachforschen-vb	investigate
Nominierung-F	nomination
Nachlass-M	discount, legacy
nachprüfen-vb	verify
nordwärts-adv	northward
nachschlagen-vb	look up
nörgeln-vb	nag
Normalität-F	normality
nächtelang-adv	night after night
Notbremse-F	emergency brake
nächtlich-adj; adv	nightly
Notlage-F	plight, emergency
nachtragend-adj;	resentful; resentfully
nuklear-adj	nuclear
nagen-vb	gnaw
Näherin-F	seamstress
nahrhaft-adj; adv	nutritious; nourishingly
nutzbar-adj	usable
Naivität-F	naivety
Namensschild-N	name tag
närrisch-adj; adv	foolish; madly
Nationalität-F	nationality
Oase-F	oasis
Obduktion-F	autopsy
obenauf-adv	on top
Oberfeldwebel-M	staff sergeant
nebenher-adv	on the side
Nebenzimmer-N	other room
neblig-adj	foggy
Obstgarten-N	orchard
necken-vb	tease
obszön-adj; adv	obscene; obscenely
Ödland-N	wasteland
Nervenkitzel-M	thrill (coll)
Nervenklinik-F	mental institution
neugeboren-adj	newborn
okkult-adj; adv	occult; occultly
Ökonomie-F	economics
Opossum-N	possum
neutralisieren-vb	neutralize
Optimist-M	optimist
oral-adj	oral
Orgie-F	orgy
orientalisch-adj	Oriental
orientieren-vb	orientate
Orientierung-F	orientation
Ortung-F	location
Ouvertüre-F	overture
Paarung-F	pairing, mating
paddeln-vb	paddle
Palais-N	palace
Panther-M	panther
Parodie-F	parody
Parzelle-F	plot, lot
Passierschein-M	pass
Pastete-F	pie
Patenkind-N	godchild
Pferdeschwanz-M	ponytail
Pflaume-F	plum
pflügen-vb	plow
Pflug-M	plow
Pförtnerhaus-N	gatehouse
Pförtner-M	janitor
Pfosten-M	post, pole
pingelig-adj; adv	philosophically
Plackerei-F	slog (coll)
Plakette-F	badge
Platin-N	platinum
platschen-vb; N	splash
plätschern-vb	splash
Plattenspieler-M	record player
Platzpatrone-F	blank (cartridge)
plausibel-adj	plausible
pochen-vb	throb, knock
Podium-N	platform, stage
Polka-F	polka
Polster-N/M	cushion
Polyp-M	polyp, octopus
Pomade-F	pomade
Popmusik-F	pop music
Popularität-F	popularity
Pore-F	pore
Portal-N	portal
Portwein-M	port
Porzellan-N	porcelain
Prachtkerl-M	hunk (coll)
Präfekt-M	prefect
prahlen-vb; N	boast
prall-adj; adv	bulging, plumply
präparieren-vb	groom, prepare
präsent-adj; N	present; gift (fml)
Präsidentschaft-F	presidency
Preisgeld-N	prize money
Quellcode-M	source code
Prellung-F	contusion
quittieren-vb	confirm, sign for
Pressesprecher-M	publicist
Primat-M; M/N	primate; primacy
Prise-F	prize, pinch
Rächer-M	avenger
Privatisierung-F	privatization
Racker-M	rascal (coll)
Raffinerie-F	refinery
Rammbock-M	battering ram
ranfahren-vb	pull over
rapide-adj; adv	rapid; rapidly
Programmierer-M	programmer
Rapport-M	report
rar-adj	rare
Rasierklinge-F	razor blade
Rasierwasser-N	aftershave
rasseln-vb; N	rattle; rattling
Rassismus-M	racism
Raster-N; M	grid; raster
Projektion-F	projection
Projektor-M	projector
Promotion-F	promotion, graduation
prompt-adj; adv	prompt; promptly
Prothese-F	prosthesis
rastlos-adj; adv	restless; restlessly
Rasur-F	shave
Proton-N	Proton
protzig-adj; adv	swanky; swankily
Provokation-F	provocation
Prozession-F	procession
prüde-adj; adv	prim; prudishly
Pseudonym-N	pseudonym
pudern-vb	powder
Pulle-F	bottle (coll)
Pulsader-F	artery
Puma-M	cougar
Punktestand-M	score
Pünktlichkeit-F	punctuality
Punktzahl-F	score
Quacksalber-M	quack
qualvoll-adj; adv	painful; painfully
Rattengift-N	rat poison
(he)rausgeben-vb	issue
(he)rausreißen-vb	tear out
Räumung-F	eviction, clearance
Raupe-F	caterpillar
rausrücken-vb	come clean (coll)
rausrutschen-vb	slip (coll)
rechtschaffen-adj	righteous
Rechtssystem-N	legal system
recken-vb; N	strain; stretching
Redefreiheit-F	freedom of speech
Redewendung-F	expression
redlich-adj; adv	honest; honestly
Redner-M	speaker
Referat-N	paper, department
reflektieren-vb	reflect
Regent-M	regent
Register-N	register, index
regulär-adj; adv	regular; regularly
rehabilitieren-vb	rehabilitate
Rollfeld-N	runway
Reim-M	rhyme
Rolltreppe-F	escalator
reinfahren-vb	pull in (coll)
Reinfall-M	failure (coll)
reingeraten-vb	get into (coll)
reinhauen-vb	dig in (coll)
rösten-vb	roast
reinpassen-vb	fit in
rostig-adj; adv	rusty; rustily
reinwaschen-vb	clear
Rotation-F	rotation
Reisepass-M	passport
Rotznase-F	brat (coll), running nose
reizbar-adj; adv	irritable; testily
Rowdy-M	thug
reizvoll-adj; adv	appealing; delightfully
rüberbringen-vb	convey (coll)
rekonstruieren-vb	reconstruct
Rubin-M	ruby
Rekonstruktion-F	reconstruction
Renaissance-F	Renaissance
Rückschlag-M	setback
rüde-adj; adv	rude; rudely
Rugby-N	rugby
ruhelos-adj; adv	restless; restlessly
Renovierung-F	renovation
ruhen-vb	rest
Rentier-N; M	reindeer; rentier
Ruhestätte-F	resting place
Rentner-M	pensioner
rühmen-vb	praise
Repräsentant-M	representative
ruhmreich-adj	glorious
Rumänien-N	Romania
rumkriegen-vb	persuade (coll)
Rundgang-M	tour
rundum-adv	round, completely
Revolverheld-M	gunfighter
Reservoir-N	reservoir
Resolution-F	resolution, petition
Rettungsring-M	life preserver
Revolte-F	revolt
Riecher-M	nose (coll)
Ringkampf-M	wrestling
Ringrichter-M	referee
ringsum-adv	around
rinnen-vb	flow, slip
Ritus-M	rite
ritzen-vb	carve
Robe-F	gown
röcheln-vb	wheeze
rupfen-vb	pluck
Rüssel-M	trunk, snout (coll)
Ruß-M	soot
rüsten-vb	prepare, arm
rutschig-adj	slippery
rütteln-vb; N	shake, rattling
Sadist-M	sadist
säen-vb	sow
saftig-adj	juicy
Sägemehl-N	sawdust
Sakrileg-N	sacrilege
Salto-M	flip
Samariter-M	Samaritan
Sammelpunkt-M	meeting point
Sandsturm-M	sandstorm
Sauberkeit-F	cleanliness
Sauerkraut-N	sauerkraut
Säugetier-N	mammal
saukalt-adj	freezing cold (coll)
Saustall-M	mess (coll)
Schabe-F	cockroach
schaben-vb	scrape
Schafott-N	scaffold
schälen-vb	peel
Schalldämpfer-M	silencer
Schaltkreis-M	circuit
Schaltung-F	circuit, gearshift
Schamhaar-N	pubic hair
schändlich-adj;	shameful; shamefully
Scharfsinn-M	acumen
Schatz-M	treasure, sweetheart
Schaukelstuhl-M	rocking chair
Scheideweg-M	crossroads
scheuen-vb; vbr	shun; be afraid
schieflaufen-vb	go wrong (coll)
Schienbein-N	shin
Schießeisen-N	gun (coll)
Schießerei-F	shooting
Schießstand-M	shooting range
Schiffbruch-M	shipwreck
schikanieren-vb	bully
Schilf-N	reed
schimmeln-vb	get moldy
Schimpfwort-N	swear word
Schläfchen-N	nap
schlaflos-adj; adv	sleepless; sleeplessly
Schlafplatz-M	place to stay
Schlagstock-M	baton
schlechthin-adv	per se, quite
schleimig-adj	slimy
Schlepper-M	tractor, tug
schleunig-adj; adv	speedy, immediately
schleusen-vb	smuggle
Schließung-F	closure
Schluckauf-M	hiccup
schlummern-vb	slumber
schmackhaft-adj;	tasty; palatably
Schmeichelei-F	flattery
schmerzvoll-adj;	painful; painfully
schmierig-adj	greasy (coll)
schmollen-vb	sulk
schmusen-vb	cuddle (coll)
schnaufen-vb; N	huff; wheeze
Schnauzbart-M	mustache
Schnauze-F	snout
Schneeball-M	snowball
Schnitzel-N	cutlet
Schnupftabak-M	snuff
Schotter-M	gravel, money (coll)
schottisch-adj	Scottish
Schottland-N	Scotland
Schramme-F	scratch
Schreiner-M	carpenter
Schüchternheit-F	shyness
Schürzenjäger-M	womanizer (coll)
Schusswechsel-M	shooting
Schusswunde-F	bullet wound
schutzlos-adj	vulnerable
Schwachpunkt-M	weakness
Schwachstelle-F	weakness
Schwan-M	swan
Seitenstraße-F	side street
Sense-F	scythe
Sensibilität-F	sensitivity
Seriennummer-F	serial number
sezieren-vb; N	dissect; dissection
Signalhorn-N	bugle
signalisieren-vb	signal
Signalton-M	beep
Signatur-F	signature
Simulator-M	simulator
simulieren-vb	simulate
sinnlich-adj; adv	sensual; sensually
Skalp-M	scalp
skandalös-adj;	scandalous;
skeptisch-adj; adv	scandalously
Skizze-F	sketch
Sohle-F	sole
schwärmen-vb	fancy, swarm
schweigend-adv;	in silence; silent
Schweinestall-M	pigsty
schwenken-vb; N	pivot, swing; pivoting
schwerlich-adv	hardly, scarcely
schwermütig-adj	wistful, depressed
Seelenfrieden-M	peace of mind
Seelenheil-N	salvation
seinerzeit-adv	at the time
Sonett-N	sonnet
Sonnencreme-F	sunscreen
Sonnenstich-M	sunstroke
sorglos-adj; adv	carefree; carelessly
sorgsam-adv; adj	carefully; careful
Spule-F	coil, reel
Spülung-F	flushing
Stabilisator-M	stabilizer
Stabschef-M	chief of staff
Stachel-M	spike, sting
Stachelschwein-N	porcupine
Stadtrand-M	outskirts
Stall-M	stable
Stammkunde-M	regular (customer)
Ständchen-N	serenade
Standesamt-N	registry office
starrköpfig-adj;	stubborn; stubbornly
stattlich-adj; adv	considerable,
Statur-F	stature, build
staubig-adj	dusty
Steg-M	jetty, bridge, web
stemmen-vb; vbr	stem; brace
Sterblichkeit-F	mortality
steril-adj; adv	sterile; sterilely
sterilisieren-vb	sterilize
Sternbild-N	constellation
Sternenstaub-M	stardust
Stickerei-F	embroidery
stickig-adj; adv	stuffy; stuffily
Stierkampf-M	bullfight
stilvoll-adj; adv	stylish; stylishly
stimulieren-vb	stimulate
Stirnband-N	headband
Stöckchen-N	(little) stick
Spähtrupp-M	patrol
Spange-F	buckle, braces
spaßen-vb	joke
Spaßvogel-M	joker (coll)
Spatzenhirn-N	birdbrain (coll)
Specht-M	woodpecker
Speer-M	spear
speicheln-vb	salivate
Spektrum-N	range
Sperrstunde-F	curfew
Spielraum-M	scope
Spielzug-M	move
spießig-adj	stuffy (coll)
splitternackt-adj	stark naked
Spontaneität-F	spontaneity
Sprechanlage-F	intercom
Sprechstunde-F	consultation, surgery
spreizen-vb	spread
Sprengkörper-M	explosive device
Sprengladung-F	explosive charge
Sprengsatz-M	explosive device
Springbrunnen-M	fountain
Spuk-M	haunting
stocksauer-adj	furious (coll)
Teamarbeit-F	teamwork
störend-adj; adv	disturbing; disturbingly
störrisch-adj; adv	stubborn; stubbornly
stranden-vb	get stranded
Strandhaus-N	beach house
Straßensperre-F	roadblock
strategisch-adv;	strategically; strategic
streitig-adj	debatable, contested
stressig-adj; adv	stressful; stressfully
Striptease-M/N	striptease
Stube-F	parlor
stubenrein-adj	housebroken
stutzen-vb	trim
Symphonie-F	symphony
Tafelrunde-F	round table
tagaus-adv	day out
tagein-adj	day in
taktisch-adj; adv	tactical; strategically
taktlos-adj; adv	tactless; tactlessly
Talkshow-F	talk show
Tarantel-F	tarantula
Taschendieb-M	pickpocket
Taschenmesser-N	pocket knife
Täufer-M	baptist
Telefonleitung-F	phone line
telegrafieren-vb	telegraph
Telepathie-F	telepathy
Terminplan-M	schedule
Termite-F	termite
terrorisieren-vb	terrorize
terroristisch-adj	terrorist
Teufelskreis-M	vicious circle
Tiefgarage-F	underground car park
tiefgründig-adj;	deep; in depth
tilgen-vb	pay off
Tippfehler-M	typo
Tischgebet-N	grace
Tischler-M	carpenter
Titan-M	titanium, titan
todernst-adj	dead serious
todkrank-adj	terminally ill
todmüde-adj	dead tired
Todsünde-F	cardinal sin
tolerant-adj; adv	tolerant; tolerantly
Tollpatsch-M	clutz (coll)
Tonbandgerät-N	tape recorder
Tonfall-M	tone of voice, intonation
tonnenweise-adv	tons of
Töpfchen-N	potty
Torso-M	torso
Törtchen-N	cupcake
Tortur-F	ordeal, torture
Torwart-M	goalkeeper
totschlagen-vb	swat, kill
tragbar-adj	portable
transferieren-vb	transfer
Transit-M	transit
Transmitter-M	transmitter
transparent-adj	transparent
Trauerfeier-F	funeral service
überhören-vb	not hear
Überläufer-M	defector
trauernd-adj	mourning
Trikot-N	jersey, leotard
Trinkgeld-N	tip
Trio-N	trio
Tritt-M	step, kick
triumphieren-vb	triumph
Trompeter-M	trumpeter
tropisch-adj	tropical
tröstlich-adj; adv	comforting;
trüb-adj	comfortingly
Trubel-M	turmoil, excitement
trügen-vb	deceive
trunken-adj	intoxicated (fml)
tschechisch-adj; N	Czech
tückisch-adj	treacherous
tugendhaft-adj;	virtuous; virtuously
Tupfer-M	swab
Türschwelle-F	doorstep
tuten-vb	hoot
Überbleibsel-N	remnant (coll)
überdauern-vb	outlive, survive
Überhand-F	upper hand
überheblich-adj;	pretentious;
Übermacht-F	superiority
übermäßig-adv;	overly; excessive
Übernachtung-F	overnight stay
übernatürlich-adj;	supernatural;
überrennen-vb	overrun
überrollen-vb	run down, overrun
überrumpeln-vb	take by surprise
übersäen-vb	strew
überschlagen-vb;	skip; lukewarm
übertönen-vb	drown (out)
überwältigen-vb	overpower
ulkig-adj	predominant
Umbau-M	reconstruction
Umdrehung-F	revolution, turn
umfahren-vb	bypass; knock down
umkippen-vb	faint (coll), tip over
umkreisen-vb	circle
umleiten-vb	redirect, divert
Umleitung-F	detour, diversion
umliegend-adj	surrounding
umringen-vb	surround
umschauen-vbr	look around
umsichtig-adj; adv	prudent; prudently
umtauschen-vb	exchange
unauffindbar-adj	untraceable
ungenau-adj; adv	inaccurate; inaccurately
ungeniert-adj; adv	unashamed;
unbarmherzig-adj;	merciless; mercilessly
unbeholfen-adj;	clumsy; awkwardly
unerbittlich-adj;	relentless; relentlessly
unerkannt-adj;	unfathomably
unfehlbar-adj; adv	infallible; infallibly
ungeahnt-adj	unforeseen
ungebildet-adj	illiterate, ignorant
ungehobelt-adj;	crude; crudely
Ungewissheit-F	uncertainty
ungewohnt-adj;	unusual; unusually
unhörbar-adj; adv	inaudible; inaudibly
unlängst-adv	recently
unlogisch-adj; adv	illogical; illogically
unnahbar-adj	aloof
unnütz-adj	useless
unorthodox-adj;	unorthodox;
unrealistisch-adj;	unorthodoxly
unrein-adj	unrealistically
unschädlich-adj	harmless
unschön-adj	messy
unsinnig-adj; adv	absurd; absurdly
unterbinden-vb	prevent
unterbreiten-vb	submit
untergeben-adj	subordinate
untergraben-vb;	undermine; undermined
unterjubeln-vb	slip
unterkommen-vb	stay
unterlaufen-vb	avoid; happen
Unterleib-M	abdomen
Unterschlagung-F	embezzlement
unterstehen-vb	be subject to
unterstreichen-vb	underline, emphasize
Untertreibung-F	understatement
Untier-N	beast
unüberlegt-adj;	rash; without thinking
unüblich-adj	unusual
unumgänglich-adj	essential, inevitable
unvergesslich-adj;	unforgettable;
unvermeidbar-adj	inevitable
unweigerlich-adv;	inevitably; inevitable
Unwesen-N	nuisance
unzerstörbar-adj	indestructible
Unzufriedenheit-F	discontent
unzulässig-adj	undue, prohibited
urinieren-vb	urinate
Urinprobe-F	urine sample
Urknall-M	big bang
Vandalismus-M	vandalism
variabel-adj; adv	variable; variably
Vektor-M	vector
verächtlich-adj;	contemptuous;
veralbern-vb	make fun of
Veranlagung-F	predisposition
verausgaben-vb	exert oneself, overspend
verbal-adj; adv	verbal; verbally
Verbannung-F	exile
verbiegen-vb	bend
verbitten-vbr	not tolerate
Verbundenheit-F	bond
verdampfen-vb	vaporize
verdauen-vb	digest
verdenken-vb	blame
verdursten-vb	die of thirst
vereidigen-vb	swear (in)
vereint-adj	united, collected
vereinzelt-adj;	scattered; here and
Verführung-F	seduction
verfüttern-vb	feed
vergänglich-adj	fleeting
vergasen-vb	gas
vergelten-vb	repay
Vergeudung-F	waste
Vergiftung-F	poisoning
vergönnen-vb	grant
vergöttern-vb	adore
vergriffen-adj	sold out, out of print
Vergünstigung-F	perk, reduction
verharren-vb	remain (fml)
verkehrt-adj; adv	wrong; wrongly
verklingen-vb	fade
verkohlen-vb	char
verkommen-adj;	depraved; go to waste;
verkorksen-vb	mess up (coll)
verkrüppeln-vb	cripple
verlagern-vb	shift, relocate
Verlegung-F	transfer
verleiten-vb	seduce
verlernen-vb	forget
Verlierer-M	loser
Verlobungsring-M	engagement ring
Verlogenheit-F	hypocrisy
vermählen-vb	marry (fml)
vermerken-vb	note, record
Vermerk-M	note, annotation
vermessen-vb; adj	measure; presumptuous
verminen-vb	mine
Vermittler-M	mediator
vermögend-adj	wealthy
Vernehmung-F	interrogation
verpatzen-vb	mess up (coll)
verräterisch-adj;	treacherous;
verrechnen-vb	offset
verrenken-vb	sprain
verrosten-vb Verrücktheit-F	rust
Versand-M	shipping
verschanzen-vb	fortify
verschiffen-vb	ship off
verschleiern-vb	conceal
verschlüsseln-vb	encrypt
Verschlüsselung-F	encryption
verschmutzen-vb;	pollute; pollution
Verschmutzung-F	pollution
verschnaufen-vb	catch one's breath
verschrecken-vb	scare off
versengen-vb	scorch
verstauen-vb	stow
Versteigerung-F	auction
verstellen-vb	adjust
verstimmen-vb;	upset; get out of tune
verstreichen-vb	elapse, spread
verstricken-vb	involve, entangle
vertikal-adj; adv	vertical; vertically
Vertrauter-M	confidant
vertrocknen-vb	dry (up)
verunglücken-vb	have an accident
verunsichert-adj	uncertain
Veruntreuung-F	embezzlement
Verurteilter-M	convict
verwählen-vbr	have the wrong number
Verwarnung-F	reprimand
verwehen-vb	cover over, blow away
verwehren-vb	deny
verwelken-vb	wither
verwerfen-vb	discard
Verwesung-F	decomposition
verwetten-vb	bet
verwundert-adj	bewildered, surprised
Verwüstung-F	devastation
Verzicht-M	waiver
vibrieren-vb	vibrate
Vlies-N	fleece
Vöglein-N	birdie
Völkermord-M	genocide
Vollendung-F	completion
volljährig-adj	of legal age
vollpumpen-vb	fill (up)
vollstopfen-vb	stuff
vollstrecken-vb	enforce
volltanken-vb	fill up
vollzählig-adj	complete
vorab-adv	in advance
vorankommen-vb	progress
voraussehen-vb	anticipate
vorbildlich-adj	exemplary, perfect
vorbringen-vb; N	allege; allegation
vordringen-vb; N	penetrate; advance
Vorgeschichte-F	(pre)history, record
vorhersehbar-adj	predictable
vorhersehen-vb	predict
Vorhut-F	vanguard
vorladen-vb	summon, preload
vorlaut-adj; adv	cheeky; flippantly
Vormarsch-M	advance
Vorrichtung-F	device, equipment
vortanzen-vb	audition (dancing)
vorteilhaft-adj;	advantageous; favorably
vortrefflich-adj;	excellent; admirably
vorwarnen-vb	warn
vorzeigen-vb	show
Wachablösung-F	changing of the guard
Waffenbesitz-M	gun possession
Waffenruhe-F	truce
wahrhaben-vb	believe
Walross-N	walrus
wälzen-vb	roll
Wanderung-F	hike, migration
Warenhaus-N	department store
Warterei-F	waiting (coll)
Warze-F	wart
Waschbär-M	racoon
Wäschekorb-M	hamper
weben-vb; N	weave; weaving
wedeln-vb	wave, wag
wegblasen-vb	blow (away)
weglegen-vb	put aside
wegmachen-vb	get rid of (coll)
wegräumen-vb	clean up
wegschmeißen-vb	ditch (coll)
wegsehen-vb	look away
wehrlos-adj; adv	defenseless;
Weiblichkeit-F	defenselessly
Weibsbild-N	woman (coll)
vital-adj	vital
Vitrine-F	cabinet
Weigerung-F	refusal
Weinberg-M	vineyard
Weinbrand-M	brandy
weismachen-vb	make believe
Wohlfühlen-N; vbr	wellness; feel
Wohlgefallen-N	pleasure
wohltätig-adj; adv	benevolent;
weiterleiten-vb	forward
weitersagen-vb	spread the word
weiterschlafen-vb	sleep on
weitersuchen-vb	keep looking
Wohltätigkeit-F	charity
wohnhaft-adj	resident
Workshop-M	workshop
Wortschatz-M	vocabulary
Wellenlänge-F	wavelength
weltlich-adj; adv	secular, worldly
Wortwahl-F	choice of words
wühlen-vb	dig
Werwolf-M	werewolf
Westentasche-F	vest pocket
Wunderland-N	wonderland
widerlegen-vb	refute
Wiederaufbau-M	reconstruction
würdigen-vb	appreciate
würzen-vb	season
Yak-M/N	yak
zahlenmäßig-adj;	numerical; numerically
Zähler-M	meter, tally
zahllos-adj	countless
willkürlich-adv;	arbitrarily; arbitrary
zahm-adj; adv	tame; tamely
zähmen-vb	tame
wimmeln-vb	swarm
wirbeln-vb; N	swirl; whirl
Wirbelsturm-M	hurricane
wirkungsvoll-adv;	effectively; effective
wittern-vb	smell
zanken-vb	quarrel
zapfen-vb; M	tap; spigot
Zaster-M	money (coll)
Zauberformel-F	incantation
Zauberkraft-F	magic (power)
Zaubertrank-M	magic potion
Zaubertrick-M	magic trick
Zeitreise-F	chronologically
zerbrochen-adj	broken
zerfleischen-vb	mangle
zerfressen-adj; vb	corroded; corrode
zerhacken-vb	chop up
zerknittern-vb	crumple
zerkratzen-vb	scratch
zerschießen-vb	shoot up
zerspringen-vb	burst
zerstreiten-vbr	fall out
zertreten-vb	trod, squash
Zielort-M	destination
Zirkel-M	circle, compass
zirpen-vb; N	chirp; chirping
zittrig-adj; adv	shaky; shakily
zivil-adj	civil, civilian
Zobel-M	sable
Zopf-M	braid
Zubehör-N	accessory
zubringen-vb	spend
zudecken-vb	cover
zudröhnen-vbr	get stoned (coll)
zugegen-adj	satisfactorily
zuhalten-vb	keep shut, cover
zumuten-vb	expect of, put through
zunähen-vb	stitch up
Zündschnur-F	fuse
zurückdrehen-vb	turn back
zurückfallen-vb	fall back
zurückfliegen-vb	fly back
Zurückhaltung-F	restraint
zurückkaufen-vb	buy back
zurücklehnen-vb	lean back
zurücksetzen-vb	reverse, reset
zurückweichen-vb	flinch, retreat
Zurückweisung-F	rejection
zurückwerfen-vb	reflect, set back
zuschreiben-vb	attribute
zusetzen-vb	nag, add
zutragen-vb; vbr	report to; happen
zuziehen-vb; vbr	draw, consult; incur
Zwangsarbeit-F	forced labor
Zwangsjacke-F	straitjacket
zweierlei-adj	two different
zweifelhaft-adj;	doubtful; doubtfully
Zweitbesetzung-F	understudy
Zweitschlüssel-M	spare key
Zypern-N	Cyprus
absetzen-vb	drop (off), sell
abbiegen-vb	turn
abdrücken-vb	shoot
Abendbrot-N	supper
abfahren-vb	leave
abfeuern-vb	fire
Abfindung-F	compensation
Abgang-M	slope
abgefahren-adj	awesome (coll); worn
abgelaufen-adj	expired, up
abstürzen-vb	crash, fall
Absturz-M	crash
abtreten-vb	resign
Abwechslung-F	variety, change
abweisen-vb	reject
abwerfen-vb	discard
Abzug-M	trigger
ächzen-vb; N	grunt; grunting
Adel-M	nobility
Ader-F	vein
adoptieren-vb	adopt
abheben-vb	take off
abhören-vb; N	eavesdrop;
abkriegen-vb	get (coll)
Abkürzung-F	abbreviation, shortcut
ablegen-vb	discard
ablenken-vb	distract
Alarmanlage-F	alarm
Alarmstufe-F	alert level
alias-adv	alias
Ablenkung-F	distraction
Abmachung-F	arrangement
allerseits-adv	everybody
abreisen-vb	depart
abreißen-vb	demolish
Alliierter-M	ally
Abschlussball-M	prom
Alptraum-M	nightmare
Alter-N; M	age; dude (coll)
abseits-adv	apart
Amateur-M	amateur
Ameise-F	ant
amüsant-adj; adv	amusing; amusingly
anbringen-vb	apply
anrühren-vb	touch
Andenken-N	memory, souvenir
ansagen-vb; N	announce;
andernfalls-adv;	otherwise
Anschein-M	appearance
anderswo-adv	elsewhere
aneinander-adv	together
anschnallen-vb	buckle (up)
anerkannt-adj	recognized
Anschuldigung-F	accusation
anfahren-vb	approach, hit
Anfänger-M	beginner
ansprechen-vb	address
Anstalt-F	institution
Anflug-M	approach, hint
ansteckend-adj	contagious
anfühlen-vb	touch, feel
anstecken-vb;	infect; catch
anstoßen-vb	drink to, nudge
anstrengen-vb;	strain; try hard
angespannt-adj;	tense; tensely
Antenne-F	antenna
Antlitz-N	face (fml)
antreiben-vb	drive, power
Angewohnheit-F	habit
ängstlich-adj;	scared; fearfully
Anwesen-N	estate
Anzahlung-F	deposit
anhaben-vb	wear
anzünden-vb	light
anhängen-vb	attach
Apotheke-F	pharmacy
Anhänger-M	pendant, follower
apropos-adv	by the way
anheuern-vb	hire (coll)
Aquarium-N	aquarium
Anker-M	anchor
Arabien-N	Arabia
Anliegen-N; vb	concern; be in contact
Ära-F	era
anmachen-vb	turn on, hit on (coll)
Anmarsch-M	coming, advance
Arbeitszimmer-N	study
annähernd-adv;	approximately;
Archiv-N	archive
Arena-F	arena
anonym-adj; adv	anonymous;
Armband-N	bracelet
Aufstellung-F	list
Arrest-M	detention
arrogant-adj; adv	arrogant; arrogantly
aufteilen-vb	split (up)
Arroganz-F	arrogance
Auftraggeber-M	client
artig-adj	good
auftreiben-vb	find (coll), raise
Artillerie-F	artillery
aufwärmen-vb	warm (up)
Aschenbecher-M	ashtray
aufwärts-adv	up
Aspirin-N	aspirin
Assistent-M	assistant
Astronaut-M	astronaut
Auktion-F	auction
Asyl-N	asylum
ausatmen-vb	exhale
Atemzug-M	breath
ausbrechen-vb	break out
Atombombe-F	atom bomb
ausbuchen-vb	book out, write off
Attacke-F	attack
Attentäter-M	assassin
Attentat-N	assassination
auserwählen-vb	choose
ätzend-adj	corrosive, lousy (coll)
ausfahren-vb	extend, drive out
Ausfahrt-F	exit, drive
ausfallen-vb	fail, fall out
ausflippen-vb	flip (coll)
auferstehen-vb	(a)rise
ausführen-vb; N	implement; performing
aufessen-vb	eat up
ausfüllen-vb	fill
auffällig-adj; adv	conspicuous;
auffinden-vb	find
ausgebildet-adj	educated
ausgefallen-adj	fancy
aufgebracht-adj	upset
ausgelassen-adj;	exuberant; exuberantly
aufgelöst-adj	upset
aufhängen-vb	hang
auslachen-vb	laugh at
aufrecht-adj; adv	upright
auslassen-vb	omit
Aufruf-M	appeal
ausliefern-vb	deliver, extradite
Aufruhr-M	turmoil
auslöschen-vb; N	extinguish; extinction
aufschlitzen-vb	slit
ausmessen-vb	measure
aufsehen-vb; N	look up; sensation
Aufseher-M	warden
auspacken-vb	unpack
Aufsicht-F	supervision
ausrasten-vb	snap (coll)
aufspüren-vb	detect
ausrauben-vb	rob
ausreichend-adj;	sufficient; sufficiently
Bandit-M	bandit
ausrutschen-vb	slip
bange-adj	anxious
aussagen-vb	testify
Bankräuber-M	bank robber
Bankrott-M; adj	bankruptcy; bankrupt
Bann-M	spell, ban
barfuß-adj; adv	barefoot
Base-F	base
Ausschuss-M	committee
Basketball-M	basketball
Bass-M	bass
außerirdisch-adj	alien
Bastard-M	bastard
Bataillon-N	battalion
Baumwolle-F	cotton
aussprechen-vb	express, pronounce
beängstigend-adj	daunting
Becher-M	cup
ausstehen-vb	stand, bear
Becken-N	basin; pelvis
bedacht-adj;	careful; carefully;
Aussterben-N; vb	extinction, die out
bedauerlich-adj;	regrettable,
Austausch-M	exchange
Bedienung-F	operation, service
auswendig-adj	by heart
bedrücken-vb	depress
Auswirkung-F	impact
Auszeichnung-F	award
Auszeit-F	time off, timeout
beerdigen-vb	bury
befassen-vb	deal
Automat-M	machine
Befehlshaber-M	commander
Autopsie-F	autopsy
befolgen-vb	follow, obey
Autorität-F	authority
befördern-vb	promote
Autoschlüssel-M	car key
Beförderung-F	promotion,
Axt-F	ax
Befragung-F	survey
Befreiung-F	liberation
befriedigen-vb	satisfy
baden-vb	bathe
befugen-vb	authorize
Badewanne-F	bathtub
Balance-F	balance
begabt-adj	gifted
Ballett-N	ballet
Ballon-M	balloon
Begehren-vb; N	desire
Banane-F	banana
begleichen-vb	settle, pay
Begleitung-F	company
Berufung-F	vocation, appeal
Begräbnis-N	burial
begrenzt-adj;	limited; terminally
beruhigend-adj;	soothing; reassuringly
Begrüßung-F	greeting
Behälter-M	container
Beherrschung-F	control
Berühmtheit-F	celebrity
behindert-adj	disabled
Berührung-F	touching
besagen-vb	indicate
beichten-vb	confess
Beileid-N	condolence
beschämen-vb	embarrass
beschatten-vb	tail, shade
beitreten-vb	join
Bescheidenheit-F	modesty
Bekanntschaft-F	acquaintance
beschießen-vb	fire
bekennen-vb	confess
bekloppt-adj	daft (coll)
beladen-vb; N	load; loading
belassen-vb	leave
beschränken-vb	confine
beschuldigen-vb	accuse
belegt-adj	busy, occupied
Beschützer-M	protector
Beleidigung-F	insult
Beleuchtung-F	lighting
beschweren-vbr;	complain, weight
belohnen-vb	reward
Besorgnis-F	concern
bessern-vb	do better
Besserung-F	improvement, recovery
Bestätigung-F	confirmation
beneiden-vb	envy
bestechen-vb	bribe
benennen-vb	designate
Bengel-M	rascal (coll)
benommen-adj;	numb; numbly
Bestrafung-F	punishment
betäuben-vb	stun
berauben-vb	rob
betrinken-vbr	get drunk
betrübt-adj; adv	saddened; sadly
betrügen-vb	deceive
bereden-vb	talk about
betteln-vb	beg
bereithalten-vb	stand by
Beule-F	bump
bergab-adv	downhill
beunruhigen-vb	worry
Beute-F	prey
Beutel-M	bag
Brocken-M	chunk
Brötchen-N	bun
bewaffnet-adj	armed
Bruch-M	break
Bewährung-F	parole
Brücke-F	bridge
brüllen-vb; N	roar; roaring
Bücherei-F	library
Buchhaltung-F	accounting
Beweisstück-N	exhibit
Budget-N	budget
Bewunderung-F	admiration
Büffel-M	buffalo
Bezahlung-F	payment
Bug-M	bow
bezaubernd-adj;	charming; charmingly
bündeln-vb	bundle
Bund-M	association, bunch
bezeugen-vb	testify, witness
Busen-M	bosom
büßen-vb	pay for
Cabrio-N	convertible
Birne-F	pear, bulb
Campus-M	campus
Casanova-M	lover boy
chaotisch-adj;	chaotic, chaotically
blank-adj	bare, broke (coll)
Chauffeur-M	chauffeur
blättern-vb	browse
checken-vb	check
chemisch-adj;	chemical; chemically
blendend-adj;	marvelous; marvelously
blockieren-vb	block
Chirurg-F	surgeon
Chirurgie-F	surgery
Blues-M	blues
Bluff-M	bluff
Christ-M	Christian
blühen-vb	bloom
Cocktail-M	cocktail
Bluse-F	blouse
Container-M	container
blutig-adj	bloody
Coup-M	coup
bombardieren-vb	bomb
boomen-vb	boom
booten-vb	boot
borgen-vb	lend, borrow
Brandstiftung-F	arson
dahinten-adv	back there
dämlich-adj	silly (coll)
Bräutigam-M	groom
Dämmerung-F	dawn
Brei-M	pulp
Damm-M	dam
brennend-adj;	burning; keenly
Dampf-M	steam
Dänemark-N	Denmark
Brigade-F	brigade
Dankbarkeit-F	gratitude
draufgehen-vb	get killed (coll)
Darbietung-F	performance
Drehung-F	rotation
Dasein-N	existence
drittens-adv	thirdly
Drohung-F	threat
Deckel-M	lid
ducken-vb	duck, humiliate
Defekt-M; adj	defect; faulty
Duell-N	duel
Dummheit-F	stupidity, silliness
durchatmen-vb	breathe
durchbrechen-vb	break
durchbrennen-vb	run away (coll); burn out
demütigen-vb	humiliate
Durchbruch-M	breakthrough
Depression-F	depression
durchdrehen-vb	go crazy (coll), spin
depressiv-adj;	depressive; depressively
durchhalten-vb	hold out
durchknallen-vb	go crazy (coll)
Durchreise-F	transit
Durchsage-F	announcement
durchschauen-vb	see through
Desaster-N	disaster
Designer-M	designer
Design-N	design
durstig-adj; adv	thirsty; thirstily
Dilemma-N	dilemma
Dimension-F	dimension
Dynastie-F	dynasty
Dinner-N	dinner
Dinosaurier-M	dinosaur
edel-adj; adv	noble; nobly
Diskretion-F	discretion
Division-F	division
egoistisch-adj;	selfish; selfishly
Dock-N	dock
Dolch-M	dagger
Donner-M	thunder
ehrgeizig-adj;	ambitious; ambitiously
Dosis-F	dose
Eiche-F	oak
Draht-M	wire
Eichhörnchen-N	squirrel
dranbleiben-vb	hang on (coll)
einatmen-vb; N	inhale; inhaling
Einbildung-F	imagination
Elektrizität-F	electricity
einbringen-vb; N	introduce; introduction
einbrocken-vb	get in trouble (coll)
eliminieren-vb	eliminate
eindringlich-adv;	strongly; urgent
Elite-F	elite
Einfahrt-F	driveway
einfangen-vb;	capture, get
einfrieren-vb	freeze
eingeben-vb	enter
Enkelin-F	granddaughter
eingebildet-adj;	conceited; smugly
entfliehen-vb	escape
Entführer-F	kidnapper
entgehen-vb	avoid
Entschädigung-F	compensation
Entschluss-M	decision
einliefern-vb	hospitalize
Entsetzen-N; vb	horror, appall
entsetzlich-adj;	terrible; terribly
einmischen-vb	blend into, interfere
einsatzbereit-adj	operational
entwischen-vb	escape
einschüchtern-vb	intimidate
entzückend-adj;	delightful; delightfully
einstecken-vb	insert
entzücken-vb	delight
Entzug-M	withdrawal
entzünden-vb	ignite
Erbarmen-N; vb	mercy; arouse pity
Einwand-M	objection
erbärmlich-adj;	pathetic; pitifully
Eiscreme-F	ice cream
erbauen-vb	build
erben-vb	inherit
Eitelkeit-F	vanity
erbitten-vb	solicit
eitern-vb	fester
Erbse-F	pea
Ekel-M; adj	disgust; disgusting (coll)
Erdnussbutter-F	peanut butter
Elefant-M	elephant
Erfinder-M	inventor
Erwärmung-F	warming
erwürgen-vb	strangle
erfrieren-vb	freeze to death
Erzbischof-M	archbishop
erhängen-vb	hang
Eskorte-F	escort
Eule-F	owl
erhören-vb	hear
erkälten-vbr	catch a cold
evakuieren-vb	evacuate
Erkältung-F	cold
Evakuierung-F	evacuation
erleichtern-vb	facilitate, relieve
Evolution-F	evolution
erleichtert-adj;	relieved
Examen-N	exam
Exemplar-N	specimen
Erleichterung-F	relief
Exil-N	exile
exklusiv-adj; adv	exclusive, exclusively
Erleuchtung-F	enlightenment
Expedition-F	expedition
erlösen-vb	redeem
Erlösung-F	salvation
ermitteln-vb	determine
Ermittler-M	investigator
Ermordung-F	murder
ernähren-vb; N	feed; nurturing
Fackel-F	torch
ernennen-vb	appoint
fade-adj; adv	bland; tastelessly
Ernte-F	harvest
Fahrstuhl-M	elevator
erpressen-vb	blackmail
Erpressung-F	blackmail
erraten-vb	guess
Fallschirm-M	parachute
Fälschung-F	forgery
Falte-F	wrinkle
erschlagen-vb;	slay; slayed
falten-vb	fold
farbig-adj	colored
erschüttern-vb	shake, shatter
faulen-vb	rot
ersparen-vb	save
Fax-N/M	fax
erstatten-vb	refund
erstaunt-adj; adv	amazed; in amazement
Feder-F	feather
erstechen-vb	stab (to death)
Feierabend-M	quitting time
ersticken-vb	suffocate
feindlich-adj; adv	hostile, adversely
erteilen-vb	grant, issue
Ferkel-N	piglet
ertrinken-vb	drown
Fernglas-N	binoculars
fernhalten-vb	keep away
Fotograf-M	photographer
fertigmachen-vb;	finish; get ready
Freak-M	freak
freilassen-vb	set free
fetzen-vb; M	shred
Freundlichkeit-F	kindness
frieren-vb	freeze
Frost-M	frost
fies-adj	nasty (coll)
frustrieren-vb	frustrate
Filmstar-M	movie star
Fund-M	find, finding
Filter-M/N	filter
filtern-vb	filter
final-adj	final
Funkkontakt-M	radio contact
finanzieren-vb	finance
fürchterlich-adj;	terrible; terribly
Fingerabdruck-M	fingerprint
Fingernagel-M	fingernail
Fürsorge-F	care
finster-adj; adv	sinister; gloomily
furzen-vb	fart (coll)
fit-adj	fit
fix-adj; adv	fixed; quickly (coll)
Flanke-F	flank
Gabel-F	fork
Fledermaus-F	bat
Gag-M	joke
flehen-vb	plead
Galgen-M	gallows
flicken-vb	mend
Gänsehaut-F	goosebumps
Flinte-F	shotgun
Gans-F	goose
flirten-vb	flirt
Flora-F	flora
Garantie-F	guarantee
Flöte-F	flute
Garde-F	guard
flüchten-vb	escape
Gärtner-M	gardener
Gastgeber-M	host
Gebet-N	prayer
Flut-F	flood, high tide
Gebieter-M	master (fml)
Föderation-F	federation
gebildet-adj	cultured, produced
foltern-vb	torture
Gebot-N	bid, command
fördern-vb	promote
gebrochen-adj;	broken; brokenly
Formel-F	formula
gebühren-vb	be due
förmlich-adv; adj	formally; formal
Formular-N	form
gedenken-vb; N	commemorate,
fortfahren-vb	proceed
fortgehen-vb	leave
gedruckt-adj	printed
geeignet-adj; adv	suitable; suitably
gefährdet-adj	endangered, vulnerable
gefällig-adj; adv	pleasing;
getrauen-vbr	dare
gefälscht-adj	forged
geübt-adj	trained, proficient
gewagt-adj; adv	daring, daringly
Gewahrsam-M	custody
Gegenleistung-F	consideration, return
gewalttätig-adj	violent
Gegenmittel-N	antidote
Gewissheit-F	certainty
gezielt-adj; adv	targeted; purposefully
gehorsam-adj; M	obedient; obedience
Gier-F	greed
Geier-M	vulture
gierig-adj; adv	greedy; greedily
Geige-F	violin
Geiger-M	violinist
giftig-adj	poisonous
geisteskrank-adj	insane
Gips-M	(plaster) cast
Geldbeutel-M	wallet
Gitter-N	grid
gleichfalls-adv	also
gemischt-adj	mixed
genehmigen-vb	approve
gleichgültig-adj;	indifferent; nonchalantly
Generator-M	generator
Gleis-N	track, platform
Genie-N	genius
Genuss-M	enjoyment
glotzen-vb	stare (coll)
gequält-adj	haunted
geradewegs-adv	straight
Glücksbringer-M	lucky charm
gerissen-adj	sly (coll)
Glückspilz-M	lucky guy (coll)
gesammelt-adj	collected, collective
Glücksspiel-N	gambling
Glückstag-M	lucky day
gönnen-vb; vbr	grant; indulge
Geschick-N	skill, fate (fml)
Gorilla-M	gorilla
Geschirr-N	dishes
göttlich-adj; adv	divine; divinely
geschlossen-adj	closed
Geschöpf-N	creature
Geschütz-N	gun
Graf-M	count, graph
Granate-F	grenade
grauenhaft-adj;	atrocious; horrifically
Gespenst-N	ghost
grauenvoll-adj;	horrid; horridly
Hebel-M	lever
hebräisch-adj; N	Hebrew
Grausamkeit-F	cruelty
Heck-N	stern
heil-adj; N	unhurt; salvation
grillen-vb; N	barbecue
Heiligabend-M	Christmas Eve
Heilmittel-N	cure
Heilung-F	healing
heimgehen-vb	go home
Heimweg-M	way home
Grube-F	pit
Heimweh-N	homesickness
grundlos-adj; adv	groundless; unfoundedly
heiter-adj; adv	cheerful; cheerfully
grunzen-vb; N	grunt
Heizung-F	heating
gruselig-adj; adv	creepy; creepily
Hektar-M/N	hectare
Gummi-M/N	rubber
herab-adv	down
herauf-adv	up
herb-adj	tart
gütig-adj; adv	kind; kindly
Herd-M	stove
gutmachen-vb	atone, make right
herhören-vb	pay attention
Habgier-F	greed
hacken-vb; F	chop; job (AT)
herschicken-vb	send (over)
Haftbefehl-M	warrant
herüber-adv	over
Häftling-M	prisoner
herumlaufen-vb	walk around
Hähnchen-N	chicken
Herzanfall-M	heart attack
Hai-M	shark
Herzschlag-M	heartbeat
Halluzination-F	hallucination
heulen-vb	howl
Halsband-N	collar, necklace
Hexe-F	witch
Hamburger-M	hamburger
Hexerei-F	witchcraft
Handbuch-N	manual
Handvoll-F	handful
hiermit-adv	hereby
Handwerk-N	craft
hiervon-adv	thereof
Harmonie-F	harmony
Highway-M	highway
hartnäckig-adj;	persistent; obstinately
himmlisch-adj;	heavenly
Haube-F	hood, cover
Hauch-M	whiff
hinab-adv	down
Hausarbeit-F	homework
hinbringen-vb	bring
Hausarrest-M	house arrest
Hindernis-N	obstacle
Hausfrau-F	housewife
hindern-vb	prevent
Haushalter-M	housekeeper
hindurch-adv	through
Haustier-N	pet
hinfallen-vb	fall (down)
Hingabe-F	devotion
Hautfarbe-F	skin color
hingehören-vb	belong (coll)
hinkommen-vb	get
hinkriegen-vb	menage (coll)
Identifizierung-F	identification
hinreißend-adj;	gorgeous; adorably
idiotisch-adj; adv	idiotic; idiotically
hinrichten-vb	execute
Hinrichtung-F	execution
Illusion-F	illusion
hinsehen-vb	look
immerzu-adv	always
hinstellen-vb	put (down)
improvisieren-vb	improvise
imstande-adj	able
Inder-M	Indian
Hinterhalt-M	ambush
Indianer-M	American Indian
Hinterkopf-M	back of the head
Hintertür-F	back door
Initiale-F	initial
Hirte-M	shepherd
hochgehen-vb	go up; explode
inne-adj; adv	aware (fml); within
innerlich-adj; adv	internal; internally
Insasse-M	inmate
hochziehen-vb	pull up
Hockey-N	hockey
Inschrift-F	inscription
Hoden-M	testicle
Insekt-N	insect
hoffnungslos-adj;	hopeless; hopelessly
inspirieren-vb	inspire
hold-adj	lovely, fair (fml)
installieren-vb	install
höllisch-adj; adv	hellish; horribly
Institution-F	institution
Instrument-N	instrument
Horizont-M	horizon
Hort-M	haven (fml)
Hospital-N	hospital
international-adj;	international;
Hotelzimmer-N	hotel room
investieren-vb	invest
Hülle-F	case
hüllen-vb	wrap
inwiefern-adv	how
Hummer-M	lobster
Irak-M	Iraq
hupen-vb	honk
hüpfen-vb	hop
Ironie-F	irony
Hüter-M	guardian
ironisch-adj; adv	ironic; ironically
Hypnose-F	hypnosis
Hypothek-F	mortgage
hysterisch-adj;	hysterical; hysterically
Jackett-N	jacket
kehren-vb	sweep, turn
Jahrestag-M	anniversary
Jahreszeit-F	season
Jahrgang-M	year, vintage
Kern-M	core
jährlich-adj; adv	annual; annually
jämmerlich-adj;	pathetic; miserably
Kessel-M	kettle
Ketchup-M/N	ketchup
jammern-vb	complain
Kick-M	kick
Jazz-M	jazz
Jeep-M	jeep
kippen-vb	tilt
kitzeln-vb	tickle
Jet-M	jet
Klan-M	clan
jetzig-adj	present
klappern-vb; N	rattle; rattling
Joint-M	joint
klarkommen-vb	get along (coll)
jucken-vb	itch
klarmachen-vb	make clear
klarstellen-vb	clarify
jugendlich-adj	youthful
Klassiker-M	classic
Justiz-F	justice
klatschen-vb	gossip
Juwel-N/M	jewel
Klatsch-M	gossip
kleiden-vb	dress
Käfer-M	beetle
klicken-vb	click
Kahn-M	boat
Kai-M	quay
Klippe-F	cliff
kaiserlich-adj	imperial
Klo-N	loo (coll)
Kakerlak-M	cockroach
Klub-M	club
Kalb-N	calf
Knabe-M	boy (CH)
Kaliber-N	caliber
Knecht-M	servant
kneten-vb	knead
knöpfen-vb	button
Kampagne-F	campaign
knurren-vb	growl
Kode-M	code
Kanzlei-F	office
Koks-M	coke (coll)
Kapelle-F	chapel, band
Kolonie-F	colony
Kolumne-F	column
Kaplan-M	chaplain
Komiker-M	comedian
Kappe-F	cap
Komitee-N	committee
Karate-N	karate
Kommando-N	command
Kardinal-M	cardinal
kommend-adj	next
Kasino-N	casino
kassieren-vb	collect
Komödie-F	comedy
kauen-vb	chew
Komplikation-F	complication
Kavallerie-F	cavalry
Komplize-M	accomplice
Kaviar-M	caviar
Kondom-N/M	condom
Kuckuck-M	cuckoo
Konsul-M	consul
kontaktieren-vb	contact
Konversation-F	conversation
Konvoi-M	convoy
Kuppel-F	dome
Kürbis-M	pumpkin
Koordinate-F	coordinate
Kurier-M	courier
Kopfgeldjäger-M	bounty hunter
Kopfhörer-M	headphone
kürzen-vb	shorten
Kopfweh-N	headache (coll)
kopieren-vb	copy
Korn-N	grain
Kusine-F	cousin
Küstenwache-F	coast guard
Kutsche-F	carriage
Korrektur-F	correction
Korridor-M	corridor
Lagerhaus-N	warehouse
lahm-adj; adv	lame; lamely
korrupt-adj	corrupted
lähmen-vb	paralyze
kostbar-adj; adv	precious; preciously
Lamm-N	lamb
Krabbe-F	crab
Langeweile-F	boredom
Kragen-M	collar
langweilen-vb;	bore; get bored
Krähe-F	crow
Kralle-F	claw
lästig-adj; adv	annoying; inconveniently
krallen-vb	claw
laufend-adv; adj	constantly; running
Läufer-M	runner
lautlos-adj; adv	silent; silently
kränken-vb	offend, hurt
Lebensform-F	form of life
krass-adj; adv	crass; crassly
Krater-M	crater
kratzen-vb	scratch
Kreide-F	chalk
kreischen-vb; N	shriek
lecken-vb	lick
Leder-N	leather
Kreuzung-F	crossing
Leichenhalle-F	morgue
Kristall-N; M	crystal(ware); crystal
Leichnam-M	body, corpse
Krokodil-N	crocodile
leichtsinnig-adj;	reckless; recklessly
Kröte-F	toad
Krug-M	jug
krumm-adj; adv	crooked; crookedly
Krüppel-M	cripple (coll)
Mandant-M	client
Lenkrad-N	(steering) wheel
manipulieren-vb	manipulate
lesbisch-adj	lesbian
männlich-adj	male, masculine
Manöver-N	maneuver
markieren-vb	mark
leugnen-vb; N	deny, denial
Marschall-M	marshal
Level-N/M	level
Märtyrer-M	martyr
Masche-F	scam (coll)
liebend-adj; adv	loving; lovingly
liebevoll-adv; adj	lovingly; loving
Massage-F	massage
Lieferwagen-M	van
Massaker-N	massacre
Lift-M	lift
Masse-F	mass
massieren-vb	massage
Limonade-F	lemonade
Limousine-F	limousine
Matratze-F	mattress
lindern-vb	alleviate
Maulwurf-M	mole
List-F	ruse
Logik-F	logic
meiden-vb	avoid
meilenweit-adv	for miles
Lok-F	engine
meinerseits-adv	for my part
losfahren-vb	set off
loslegen-vb	get going (coll)
Lotto-N	lottery
Melone-F	melon
loyal-adj; adv	loyal; loyally
Menü-N	menu
Luder-N	slut (coll)
Luftwaffe-F	air force
Lump-M	rascal
Metro-F	metro
Lunch-M	lunch
Metzger-M	butcher
Meuterei-F	mutiny
lutschen-vb	suck
Mikrofon-N	microphone
Missachtung-F	contempt
magisch-adj; adv	magical, magically
Mahlzeit-F	meal
Misstrauen-N; vb	distrust
Mais-M	corn
Nachname-M	last name
nachschauen-vb	look up
Nachschub-M	supplies
Mitbewohner-M	roommate
Nachthemd-N	nightgown
Mitbürger-M	fellow citizen
Nagel-M	nail
nahen-vb	approach
mithalten-vb	keep up
mitkriegen-vb	realize (coll)
mitspielen-vb	play along
Mitteilung-F	communication, message
Neger-M	Negro (coll)
neidisch-adj; adv	envious; enviously
mittendrin-adv	in the middle
Neid-M	envy
Mittler-M	mediator
neigen-vb	incline
Neigung-F	inclination
Nervensäge-F	nag (coll)
modeln-vb; N	model (coll); modeling
Neuanfang-M	fresh start
neuerdings-adv	lately
Neugier-F	curiosity
Mönch-M	monk
Monitor-M	monitor
Nickerchen-N	nap
Niere-F	kidney
Morgengrauen-N	dawn
Niete-F	loser (coll), rivet
Moschee-F	mosque
nimmer-adv	never (AT)
Nonne-F	nun
Mühle-F	mill, grinder
Mumie-F	mummy
Munition-F	ammunition
Norm-F	norm
munter-adj; adv	cheerful; cheerfully
Notarzt-M	emergency (doctor)
Notaufnahme-F	emergency room
Musical-N	musical
notieren-vb	note
Mutation-F	mutation
Notizbuch-N	notebook
mysteriös-adj;	mysterious; mysteriously
Notruf-M	distress call
Nudel-F	noodle
Nuss-F	nut
Nutte-F	whore (coll)
nachgeben-vb	give in
oberflächlich-adj;	superficial; superficially
nachkommen-vb	fulfill, comply with
Oberin-F	matron
Obhut-F	care (fml)
Pfeffer-M	pepper
Ochse-M	ox
öde-adj; adv; F	bleak; bleakly; wasteland
Offenbarung-F	revelation
pflücken-vb	pick
Pfote-F	paw
Option-F	option
Phantom-N	ghost
Organ-N	organ
Picknick-N	picnic
Orgasmus-M	orgasm
piepsen-vb; N	beep; beeping
Pier-M	jetty
pink-adj	pink
Pinsel-M	brush
plagen-vb	plague
Plastik-N; F	plastic, sculpture
Plätzchen-N	spot; cookie
platzieren-vb	place
plaudern-vb	chat (coll)
Poesie-F	poetry
paaren-vb	pair
Poker-N/M	poker
Päckchen-N	parcel
polieren-vb; N	polish; polishing
Packung-F	package
poltern-vb; N	rumble; cluttering
Pakt-M	pact
Pony-M; N	bangs; pony
Palästina-N	Palestine
Portion-F	portion
Papagei-M	parrot
Port-M	port
Parade-F	parade
Paranoia-F	paranoia
prächtig-adj; adv	splendid; magnificently
paranoid-adj	paranoid
Präsentation-F	presentation
Parasit-M	parasite
Präsenz-F	presence
Pärchen-N	couple
Parfum-N	perfume
predigen-vb	preach
Pariser-M; adj	Parisian
preisen-vb	praise
Park-M	park
Premier-M; adj	Prime Minister; führend
passend-adj; adv	suitable; suitably
Priorität-F	priority
Patron-M	patron
Privatleben-N	private life
Patrouille-F	patrol
Privatsphäre-F	privacy
Peitsche-F	whip
Privileg-N	privilege
Pension-F	pension, guesthouse
Perfektion-F	perfection
Produzent-M	producer
Perle-F	pearl, bead
produzieren-vb	produce
pervers-adj; adv	perverted; perversely
Ratschlag-M	advice
rauben-vb	rob
Raubüberfall-M	robbery
Rauschen-N; vb	noise; rustle
Propaganda-F	propaganda
Prophet-M	prophet
Prophezeiung-F	prophecy
prostituieren-vb	prostitute
Prostituierte-F	prostitute
räuspern-vb	clear one's throat
Prototyp-M	prototype
provozieren-vb	provoke
prügeln-vb	fight
Psychopath-M	psychopath
Pub-N/M	pub
Razzia-F	(police) raid
Pudding-M	pudding
Pulli-M	jumper (coll)
Pullover-M	sweater
Pulver-N	powder
Rebellion-F	rebellion
pumpen-vb	pump
Punk-M	punk
pur-adj	pure, neat
Puste-F	puff (coll)
pusten-vb	blow (coll)
Putzfrau-F	cleaning lady
quälen-vb	torture
Qual-F	torment
Quarantäne-F	quarantine
Quarterback-M	quarterback
Quartier-N	quarters, district
Quittung-F	receipt
Quote-F	quota
rächen-vb	avenge
raffiniert-adj;	subtle; artfully
(he)rangehen-vb	approach
rankommen-vb	get
Regenschirm-M	umbrella
reiben-vb	rub
(he)reinfallen-vb	fall for (coll)
Reinheit-F	purity
Rennbahn-F	(race) track
Reserve-F	reserve
reservieren-vb	reserve
Reservierung-F	reservation
respektlos-adj;	disrespectful;
Sanatorium-N	sanatorium
Sattel-M	saddle
Retter-M	savior
Revolver-M	revolver
säubern-vb	clean
Riegel-M	latch
Sauce-F	sauce
Sauerei-F	mess
Rind-N	beef
ringen-vb; N	wrestle, struggle
Säufer-M	drunk (coll)
saugen-vb	suck
roh-adj; adv	raw; roughly
Sauna-F	sauna
Romantik-F	romance
Schachmatt-N	checkmate
Romanze-F	romance
Schacht-M	shaft, well
römisch-adj	Roman
Schale-F	bowl, shell
schalen-vb	peel
Routine-F	routine
Schal-M; adj	scarf, stale
Rubel-M	ruble
Schalter-M	switch, counter
Scharfschütze-M	sniper
rucken-vb	jolt
Schaufel-F	shovel
rückgängig-adj	undone
schaufeln-vb	shovel
Schaukel-F	swing
rührend-adj	touching
schaukeln-vb	rock
Schauspiel-N	play
Scheinwerfer-M	headlight
Scheißdreck-M	shit (coll)
(he)rumsitzen-vb	sit around
Schenkel-M	thigh
scheu-adj; F	shy; awe
Rumpf-M	hull
scheußlich-adj;	hideous; hideously
Schick-M; adj	style; chic
Schiedsrichter-M	referee
Schimmer-M	gleam, idea (coll)
Schirm-M	umbrella, screen
schlachten-vb	slaughter
Schlacht-F	battle
Sackgasse-F	dead end
Schlaftablette-F	sleeping pill
Schlaganfall-M	stroke
Sahne-F	cream
Schlamassel-M/N	mess (coll)
Salami-F/M	salami
Schlauch-M	tube
Same-M	seed
schleichen-vb	sneak
Sammler-M	collector
Schleier-M	veil, shroud
schleifen-vb	drag; grind
Schwerkraft-F	gravity
Schleppe-F	train
schleppen-vb	drag
Schließfach-N	locker
Schlips-M	tie (coll)
Schlucht-F	ravine
schwindelig-adj;	dizzy; dizzily
schmelzen-vb	melt
Schwindel-M	fraud
schmerzhaft-adv;	painfully; painful
schwindeln-vb	cheat
Schwindler-M	fraud
Schmetterling-M	butterfly
schwindlig-adj	dizzy
Schmied-M	blacksmith
schwingen-vb	swing
schmieren-vb	grease
schwitzen-vb	sweat
schmuggeln-vb	smuggle
Schwung-M	momentum
Schmutz-M	dirt
schnarchen-vb	snore
Segel-N	sail
schnüffeln-vb	snoop
Seide-F	silk
Schnurrbart-M	mustache
Sekt-M	champagne
schockieren-vb	shock
selig-adj	blessed
schonen-vb; vbr	spare; take it easy
Senior-M	senior
Schöpfer-M	creator
Schöpfung-F	creation
Sensation-F	sensation
sensibel-adj; adv	sensitive, sensitively
schrauben-vb;	screw; spiral
Sensor-M	sensor
sentimental-adj	sentimental
Schrift-F	font, writing
Serienmörder-M	serial killer
servieren-vb	serve
Seufzer-M	sigh
Schublade-F	drawer
schubsen-vb	nudge, push (coll)
Schuft-M	villain
sichergehen-vb	be sure
Schurke-M	villain
Schüssel-F	bowl
sicherstellen-vb	ensure
Schutzengel-M	guardian angel
Schwächling-M	weakling
sichten-vb	sight
Sichtkontakt-M	visual
Siegel-N	seal
simpel-adj; adv	simple; simply
Single-M; F; N	single; single record;
schwellen-vb; N	swell
Sirene-F	siren
spucken-vb	spit
Skelett-N	skeleton
spülen-vb	rinse
Ski-M	ski
Stacheldraht-M	barbed wire
Skorpion-M	skorpion
Stadion-N	stadium
Staffel-F	relay, season
sofortig-adj	instant
Standpunkt-M	position
Söldner-M	mercenary
Stapel-M	pile
Solo-N; adj; adv	solo
startklar-adj	ready to go
Sonde-F	probe
stationieren-vb	deploy
sonderbar-adj;	weird; weirdly
stattgeben-vb	grant
Sonnenlicht-N	sunlight
stauen-vb	jam
Sonnenschein-M	sunshine
Staunen-N; vb	amazement, wonder
Sonnensystem-N	solar system
stehenbleiben-vb	stop
steif-adj; adv	stiff; stiffly
Soße-F	sauce
Stempel-M	seal, stamp
stempeln-vb	stamp
sterblich-adj	mortal
sticken-vb; N	embroider; embroidery
Stiefmutter-F	stepmother
Stier-M	bull
speisen-vb	dine
stiften-vb	donate
spenden-vb	donate
Sperma-N	sperm
stillen-vb; N	breastfeed;
Spiegelbild-N	reflection
stillhalten-vb	stand still
Spieß-M	skewer
stillstehen-vb	stand still
Spind-M/N	locker
Spital-N	hospital
Stipendium-N	scholarship
spitz-adj; M	pointed; tip (AT)
stolpern-vb	stumble
Spitzname-M	nickname
stopfen-vb	plug
Sträfling-M	convict
Spot-M	commercial
streicheln-vb	stroke
Streichholz-N	match(stick)
Sprengstoff-M	explosive
Streifenwagen-M	patrol car
Sprichwort-N	proverb, saying
Streik-M	strike
Sprit-M	gas (coll), booze (coll)
Spritztour-F	joy ride (coll)
Strenge-F	rigor
stressen-vb	stress (coll)
Sprung-M	jump
Strick-M	rope
strömen-vb	stream
Strumpf-M	stocking
Techniker-M	technician
Stückchen-N	(small) piece
Teenager-M	teenager
Teich-M	pond
stur-adj; adv	stubborn; obstinately
stürmen-vb	storm
Telefonzelle-F	phone booth
Stützpunkt-M	base
Telegramm-N	telegram
Teleskop-N	telescope
Temperament-N	temper
süchtig-adj	addicted
Terminal-M/N;	terminal
Südafrika-N	South Africa
Südamerika-N	South America
Terrain-N	terrain, territory
Terrasse-F	terrace
Territorium-N	territory
Summer-M	buzzer
Terror-M	terror
sündigen-vb	sin
texten-vb	text
surfen-vb; N	surf; surfing
suspendieren-vb	suspend
Sympathie-F	sympathy
sympathisch-adj;	nice, nicely
tierisch-adj; adv	animal, bestially
tippen-vb	type
Syndikat-N	syndicate
Todesstrafe-F	death penalty
Todesursache-F	cause of death
Tomate-F	tomato
tabu-adj	taboo
töricht-adj; adv	foolish; foolishly
Tafel-F	board, bar
Tournee-F	tour
tagelang-adv; adj	for days, daylong
träge-adj; adv	sluggish; sluggishly
tagsüber-adv; adj	during the day
Taktik-F	tactic
Takt-M	stroke, tact
Transporter-M	van
Tango-M	tango
Transport-M	transport
Tarnung-F	disguise
trauern-vb	mourn, grieve
Taschentuch-N	handkerchief
Treibstoff-M	fuel
Tätowierung-F	tattoo
tauen-vb	thaw
Tresor-M	safe
taugen-vb	be good
Tresorraum-M	vault
Tau-M; N	dew; rope
Trinker-M	drinker
Täuschung-F	deception
Trip-M	trip
Uhrzeit-F	time (of day)
trommeln-vb	drum
ultimativ-adj;	ultimate; ultimately
Trompete-F	trumpet
trösten-vb	console
Umarmung-F	hug
Truhe-F	chest
umfallen-vb	fall down, capitulate
Trupp-M	squad
Truthahn-M	turkey
tüchtig-adj; adv	efficient; hard
umgehend-adv;	immediately; immediate
Tugend-F	virtue
Tumor-M	tumor
Umhang-M	cloak
Türkei-F	Turkey
umher-adv	around
türkisch-adj; N	Turkish
umkehren-vb	reverse
Türklingel-F	doorbell
umkommen-vb	die
Tyrannei-F	tyranny
Umkreis-M	perimeter
Umlaufbahn-F	orbit
umsehen-vbr	look around
umstellen-vb	adjust, surround
überbringen-vb	deliver
Umweg-M	detour
überdenken-vb	rethink
umzingeln-vb	surround
Überdosis-F	overdose
unauffällig-adj;	independent
Übergabe-F	handover, delivery
übermitteln-vb	convey
unbesiegbar-adj	invincible
unbewaffnet-adj	unarmed
unerhört-adj;	undecided, tie
Überstunde-F	overtime
überstürzen-vb	rush
Überwachung-F	supervision
unfassbar-adj;	incomprehensible;
Ungar-M	Hungarian
Ufo-N	UFO
ungut-adj	bad, uncomfortable
universal-adj;	universal; universally
vage-adj; adv	vague; vaguely
unmoralisch-adj;	immoral; immorally
Vase-F	vase
Ventil-N	valve
verabscheuen-vb	detest
unruhig-adj; adv	restless; uneasily
verachten-vb	despise
unsterblich-adj	immortal
Verachtung-F	contempt
Unsterblichkeit-F	immortality
verängstigen-vb	frighten
Unterbrechung-F	interruption
Unterdrückung-F	repression
Untergrund-M	underground
verbannen-vb	banish
verblüffend-adj;	striking; strikingly
Unterhose-F	underpants
Unterkunft-F	accommodation
Unteroffizier-M	sergeant
verbreitet-adj	common
Verbrennung-F	burn
verbünden-vb	join forces
Unterschlupf-M	shelter
Untertan-M	subject
verdrehen-vb	twist
unterwerfen-vb;	subject; capitulate
verehren-vb	worship
vereinbart-adj	agreed, appointed
verfallen-vb; adj	expire; expired
verfehlen-vb	miss
verfehlt-adj	inappropriate, missed
unversehrt-adj	intact
verflixt-adj; adv	darn; confoundedly
verführen-vb	seduce
Urin-M	urine
Urkunde-F	deed, document
Vergebung-F	forgiveness
Vergeltung-F	retribution
vergeuden-vb	waste
vergießen-vb	spill
verheimlichen-vb	conceal
versenken-vb;	sink; immerse
verhexen-vb	jinx
verhören-vb; vbr	interrogate, mishear
Versetzung-F	transfer
verjagen-vb	scare off
versiegeln-vb	seal
verklagen-vb	sue
verkleiden-vb	disguise, dress up
verständig-adj;	understanding; maturely
verknallen-vb	have a crush (coll)
verkünden-vb	announce
Verlegenheit-F	embarrassment
Verleger-M	publisher
Verstärkung-F	reinforcement
verleugnen-vb	deny
verstopfen-vb;	clog; congest
Verlobung-F	engagement
verstört-adj; adv	distraught; haggardly
vermehren-vb	multiply
vermisst-adj	missing, lost
vermitteln-vb	convey, give
Vernichtung-F	destruction
Verstoß-M	violation
verstreuen-vb	scatter
Versuchung-F	temptation
vertauschen-vb	exchange
verrecken-vb	die (coll)
verreisen-vb	travel
verriegeln-vb	latch
verrotten-vb	rot
versäumen-vb	miss, fail
verschlafen-adj;	sleepy; oversleep;
verschlingen-vb;	sleepily
vertuschen-vb	cover up
verüben-vb	commit
verwechseln-vb	confuse
verwirrend-adj	confusing
verschlucken-vb	swallow
Verwirrung-F	confusion,
Verschluss-M	shutter
verwöhnen-vb	spoil
verschonen-vb	spare
verschütten-vb	spill
verzaubern-vb	enchant
verschweigen-vb	conceal
verzerren-vb	distort
Verzögerung-F	delay
Verzweiflung-F	despair
Video-N	video
Vulkan-M	volcano
Visier-N	visor
Wachmann-M	security guard
Visitenkarte-F	business card
wachsam-adj;	alert; attentively
Vitamin-N	vitamin
Wachtmeister-M	sergeant (AT)
vollbringen-vb	accomplish
wählerisch-adj	picky
vollenden-vb	complete
Vollidiot-M	retard (coll)
Volltreffer-M	bull's eye
wahrhaft-adv;	truly; true
voreilig-adj; adv	premature; prematurely
wahrlich-adv	truly
Waise-F	orphan
vorfallen-vb	happen to
vorführen-vb	show
Wal-M	whale
Vorgesetzte-M/F	superior
Walzer-M	waltz
Wandern-vb; N	hike; hiking
Wanne-F	bathtub
Wanze-F	bug
vormachen-vb;	fool; show
Vorname-M	first name
Wasserfall-M	waterfall
vornehm-adj;	distinguished; nobly
Wechselgeld-N	change
vornehmen-vb	make, carry out
Vorrat-M	supply
wegtreten-vb	be dismissed, step away
Vorschuss-M	advance
wehren-vb; vbr	oppose (coll); fight back
Vorspiel-N	foreplay
vorsprechen-vb	audition
weichen-vb	yield, soak
Weide-F	meadow, willow
vortreten-vb	step forward
weigern-vb	refuse
Vorurteil-N	prejudice
Vorwand-M	excuse
weiterhelfen-vb	help (along)
weiterleben-vb	live on
Welpe-M	puppy
Yacht-F	yacht
Weltraum-M	space
zäh-adj; adv	tough; tenaciously
Zange-F	pliers
Wettkampf-M	competition
zart-adj; adv	tender, tenderly
zärtlich-adj; adv	tender; tenderly
widersetzen-vbr	resist
Zauberei-F	magic
Zauberer-M	wizard
Zeitalter-N	age, period
wiederhaben-vb	have back
Zeitmaschine-F	time machine
zerbrechen-vb	break
wiehern-vb	whinny
zerbrechlich-adj;	fragile; fragilely
Wildnis-F	wilderness
zerfetzen-vb	shred
willens-adj	willing (fml)
zerquetschen-vb	crush
wimmern-vb; N	whimper; whimpering
zerschlagen-vb;	smash; shattered
Wirbel-M	vortex, vertebra
Wirbelsäule-F	spine
Zerstörer-M	destroyer
Wirt-M	host, landlord
Zeugenstand-M	(witness) stand
wischen-vb	wipe
Zigeuner-M	gypsy
Witwer-M	widower
zischen-vb	hiss
wohlauf-adj	well
Wohlergehen-N	welfare
Wohlstand-M	prosperity
Zoll-M	customs, inch
zornig-adj; adv	furious; furiously
züchten-vb	breed, grow
wörtlich-adv; adj	literally; literal
Wrack-N; adj	wreck, wrecked
würdig-adj; adv	worthy; worthily
Würfel-M	cube, dice
Zufriedenheit-F	satisfaction
zugelassen-adj	authorized
Wurzel-F	root
zukommen-vb	get; befit
zuliebe-adv	for sake
zumachen-vb	close (coll)
Zünder-M	detonator
Zündung-F	ignition
Zuneigung-F	affection
zunichte-adj	destroyed
zurichten-vb	manage
zuschlagen-vb	slam, strike
zustoßen-vb	happen to
Zutat-F	ingredient
zurückholen-vb;	retrieve
zuteilen-vb	assign
zutiefst-adv	deeply
zurückzahlen-vb	pay back
Zwischenfall-M	incident
Zwischenzeit-F	meantime
zwitschern-vb; N	chirp; tweet
albern-adj	silly
andauernd-adv; adj	constantly; ongoing
andermal-adv	another time
anfassen-vb	touch
angeklagt-adj	accused
angeln-vb; N	fish; fishing
anklagen-vb	accuse, charge
anlügen-vb	lie to
abbrechen-vb	cancel, stop
abgeschlossen-adj	enclosed, closed
abhalten-vb	discourage
abmachen-vb	arrange, remove
Abschaum-M	scum (coll)
absichtlich-adv; adj	intentionally;
anschießen-vb	shoot
anständig-adj; adv	decent; decently
Asche-F	ash
aufwachen-vb	wake up
Aufzug-F	elevator
ausgeschlossen-adj	impossible
aussetzen-vb	expose
Ausrede-F	excuse
Beerdigung-F	funeral
befinden-vbr; vb	be situated; decide
befreien-vb	free
Bach-M	brook
begraben-vb	bury
Bande-F	gang
Baseball-M	baseball
behaupten-vb	claim
beißen-vb	bite
belästigen-vb	bother
beleidigen-vb	offend
beleidigt-adj; adv	offended; sulkily
Belieben-N; vb	convenience; please
bellen-vb	bark
Belohnung-F	reward
belügen-vb	lie to
Benehmen-N; vbr	behavior, behave
benötigen-vb	need
Benzin-N	petrol
bereuen-vb	regret
berufen-vb; adj	appoint; competent
Besatzung-F	crew, occupation
besessen-adj	obsessed
besetzt-adj	occupied, busy
besiegen-vb	defeat, beat
besoffen-adj	drunk (coll)
besorgen-vb	get, procure
besorgt-adj; adv	concerned;
Besprechung-F	meeting
Bestie-F	beast
bestrafen-vb	punish
Betrüger-M	fraud
betrunken-adj	drunk
bewachen-vb	guard
bewundern-vb	admire
bewusstlos-adj	unconscious
bezweifeln-vb	doubt
blasen-vb	blow
Blutdruck-M	blood pressure
bluten-vb	bleed
Blut-N	blood
Bock-M	buck, ram
boxen-vb	box
Brand-M	fire
Braut-F	bride
bremsen-vb	brake
Brieftasche-F	wallet
brillant-adj; adv	brilliant; brilliantly
Brite-M	British
buchen-vb	book
Buchhalter-M	accountant
Bude-F	hut
Bulle-M	bull; cop (coll)
bumsen-vb	f*ck (coll), thump
campen-vb	camp
ermorden-vb	murder
erobern-vb	conquer
entspannt-adj	relaxed
erschrecken-vb	scare
ertönen-vb	sound
Etage-F	floor, level
Ex-M/F; pfx	ex
fabelhaft-adj; adv	fabulous; fabulously
fällen-vb	make, fell
fangen-vb	catch
fassen-vb	take, believe
feige-adj; adv	cowardly
Feigling-M	coward
fesseln-vb	tie up
fett-adj; N	fat
Feuerzeug-N	lighter
Finsternis-F	darkness
fischen-vb	fish
Flagge-F	flag
Flamme-F	flame
Flieger-M	aviator, plane (coll)
flott-adj; adv	fast (coll)
faul-adj; adv	lazy; lazily
frech-adj; adv	cheeky; impudently
Friseur-M	hairdresser
Fuchs-M	fox
Führerschein-M	driver's license
Funken-M; vb	spark; radio
Futter-N	feed
füttern-vb	feed
gebären-vb	give birth to
gefälligst-adv	kindly (coll)
geil-adj	awesome; horny
Gelächter-N	laughter
gelassen-adv; adj	calmly; calm
gemein-adj; adv	mean, common;
Gesang-M	singing
Geschrei-N	shouting
gesegnet-adj	blessed
gespannt-adj; adv	curious; eagerly
Gestank-M	stench
Gift-N	poison
Gnade-F	mercy
gnädig-adj; adv	gracious; graciously
graben-vb; M	dig; ditch
Gräfin-F	countess
gratis-adj; adv	free
grausam-adj; adv	cruel; cruelly
grün-adj; N	generously
Gürtel-M	belt
Hahn-M	tap, rooster
Haken-M; vb	hook
Handtuch-N	towel
hart-adj; adv	harmlessly
hauen-vb	cut, hit
heilen-vb	heal
hereinlegen-vb	trick (coll)
Honig-M	honey
Hühnchen-N	chicken
Huhn-N	chicken, hen
Hure-F	whore
husten-vb; M	cough
hüten-vb	guard
Herzinfarkt-M	heart attack
Herzog-M	duke
hilfreich-adj	helpful
Hintern-M; cntr	butt; behind the
höflich-adj; adv	polite; cordially
jubeln-vb	cheer
Jungfrau-F	virgin
junior-adj; M	junior
Kabine-F	cabin
Kacke-F	poo (coll)
Käfig-M	cage
Kanone-F	gun
kapieren-vb	understand (coll)
Karre-F	cart
Kater-M	hangover (coll), tomcat
Kaution-F	deposit
Kehle-F	throat
Keks-M/N	biscuit
Kellner-M	waiter
keuchen-vb	gasp
kichern-vb	giggle
irre-adj; M/F	crazy, maniac
klauen-vb	steal (coll.)
Klemme-F	jam (coll)
knacken-vb	crack
knallen-vb	bang
knarren-vb	creak
Knopf-M	button
Knoten-M; vb	knot
Kofferraum-M	trunk
Koma-N	coma
königlich-adj; adv	royal, royally
Korb-M	basket
köstlich-adj; adv	delicious; deliciously
kotzen-vb	puke (coll)
krachen-vb; N	crash
Kratzer-M	scratch
Krawatte-F	tie
Krebs-M	cancer, crab
kreisen-vb	circle
Krone-F	crown
Kuh-F	cow
Kühlschrank-M	fridge
kümmern-vb	take care of
Kumpel-M	mate (coll)
Kuss-M	kiss
lächerlich-adj; adv	ridiculous;
landen-vb	land
Landung-F	landing
Laster-M	truck (coll)
lauten-vb	be (based)
lebend-adj	alive
lebendig-adj; adv	alive
Leber-F	liver
leck-adj; N	leaky; leak
Legende-F	legend
Leinen-N; adj	linen
Lektion-F	lesson
Liebhaber-M	lover
Liebling-M	darling
Lizenz-F	license
Löffel-M	spoon
Maul-N	mouth (coll)
meistern-vb	master
Löwe-M	lion
lügen-vb	lie
Lunge-F	lung,
Mädel-N	girl (coll)
Mafia-F	mafia
Marine-F	navy
Marke-F	brand
marschieren-vb	march
marsch-M	march
matt-adj	matt, dull
Meldung-F	message
mies-adj	lousy (coll)
Mission-F	mission
Mist-M	shit, manure
nachsehen-vb	check
Nadel-F	needle
Narbe-F	scar
Narr-M	fool
Neffe-M	nephew
Müll-M	garbage
mutig-adj; adv	brave; bravely
neulich-adv	the other day
Mütze-F	cap, hat
niedlich-adj	cute
Notfall-M	emergency
Notiz-F	note
nüchtern-adj; adv	sober; soberly
Palast-M	palace
Pfad-M	path
pfeifen-vb	whistle
Pfeil-M	arrow, dart
pflanzen-vb	plant
piepen-vb; nnpl	beep; bucks (coll)
Pilot-M	pilot
pinkeln-vb	pee (coll)
Pirat-M	pirate
ohnmächtig-adj	unconscious
ölen-vb	oil
Pizza-F	pizza
platt-adj	flat
pleite-adj; F	broke (coll);
prima-adj; adv	great; fine
punkten-vb	score
Puppe-F	doll
Quatsch-M	nonsense (coll)
quitt-adj	quits
Rasen-M; vb	lawn; dash
Räuber-M	robber
(he)rausholen-vb	get out
Rebell-M	rebel
Regie-F	direction
reichlich-adj; adv	plenty
Reifen-M; vb	tire; mature
reizend-adj; adv	lovely; gracefully
Revolution-F	revolution
Ritter-M	knight
Rollstuhl-M	wheelchair
rückwärts-adv	backward
rudern-vb	row
Ruhm-M	fame, glory
sachte-adj; adv	gentle; gently (coll)
satt-adj	full, rich
Schachtel-F	box
Schädel-M	skull
Schaf-N	sheep
Schande-F	shame
Schätzchen-N	sweetie
Scheck-M	check
Schere-F	scissors
Scherz-M	joke
schieben-vb	push
schießen-vb	shoot
Schild-N; M	sign; shield
Schläger-M	bat, beater
schlau-adj; adv	smart; cleverly
schluchzen-vb	sob
schlucken-vb	swallow
schmecken-vb	taste
schmeißen-vb	throw (coll)
schnappen-vb	grab, catch
Schnaps-M	booze (coll)
schreien-vb	scream
schüchtern-adj; adv	shy; shyly
schulden-vb	owe
Schuppen-M; nnpl	shed; dandruff
Schwachkopf-M	moron (coll)
Schwanz-M	c*ck (coll), tail
schwören-vb	swear
segnen-vb	bless
Seil-N	rope
Sofa-N	sofa
seufzen-vb	sigh
Sex-M	sex
Spielzeug-N	toy
Spinne-F	spider
spinnen-vb	spin, be mad (coll)
Spinner-M	weirdo (coll)
Spion-M	spy
sprengen-vb	blow up
Stab-M	rod
Stange-F	pole
stürzen-vb	fall, overthrow
stechen-vb	stab; sting
Sünde-F	sin
stehlen-vb	steal
Suppe-F	soup
Tabak-M	tobacco
Stift-M	pen
tanken-vb	refuel
Tankstelle-F	gas station
stinken-vb	stink
tapfer-adj; adv	brave; bravely
stöhnen-vb	groan
taub-adj	deaf
stoppen-vb	stop, clock
Tempel-M	temple
Torte-F	cake
Trick-M	trick
Tropfen-M; vb	drop, drip
Trost-M	comfort
Tüte-F	bag
überaus-adv	extremely
überfallen-vb	attack
überlassen-vb	leave
überreden-vb	persuade
überzeugen-vb	convince
überzeugt-adj	convinced
Umschlag-M	envelope
umwerfend-adj; adv	stunning; stunningly
ungern-adv	monster
unhöflich-adj; adv	rude; impolitely
Uniform-F	plain
urteilen-vb	judge
verabreden-vb	arrange
Verabredung-F	appointment
verärgert-adj; adv	upset; crossly
verbergen-vb	hide
verderben-vb	spoil
vergewaltigen-vb	rape
Vergewaltigung-F	rape
vergiften-vb	poison
vergraben-vb	bury
verhungern-vb	starve
verirren-vb	get lost
verlobt-adj	engaged
verloren-adj	lost
vermasseln-vb	mess up (coll)
verprügeln-vb	beat up
verraten-vb; vbr	betray; reveal
Verräter-F	traitor
Verrat-M	betrayal
verrücken-vb	move, shift
verwunden-vb	wound
verzweifelt-adv; adj	desperately;
Vieh-N	cattle
Verschwörung-F	conspiracy
verschwenden-vb	waste
verschwinden-vb	disappear
vertragen-vb	tolerate, take
Vorfahre-M	ancestor
Vorfall-M	incident
verwickeln-vb	involve, engage
vorwärts-adv	forward
Wahnsinn-M	madness
Wette-F	bet
widerlich-adj; adv	disgusting;
Witwe-F	widow
woanders-adv	somewhere else
Wunder-N	miracle
wundern-vb; vbr	surprise; wonder
zaubern-vb	do magic
Zaun-M	fence
zeihen-vb	accuse (fml)
Zentrale-F	headquarters
Zoo-M	zoo
Zwerg-M	dwarf
Zwilling-M	twin
